"common_name","state","sample_year","positive_sites","sexed_fish","unsexed_fish","lengthed","aged","otoliths","data_type"
"arrowtooth flounder",NA,2003,191,4502,0,4502,512,857,"nwfsc_wcgbt"
"arrowtooth flounder",NA,2004,168,2713,0,2713,485,202,"nwfsc_wcgbt"
"arrowtooth flounder",NA,2005,215,3932,3,3935,853,4,"nwfsc_wcgbt"
"arrowtooth flounder",NA,2006,189,3030,6,3036,475,260,"nwfsc_wcgbt"
"arrowtooth flounder",NA,2007,227,3520,32,3552,0,894,"nwfsc_wcgbt"
"arrowtooth flounder",NA,2008,228,3221,6,3227,0,874,"nwfsc_wcgbt"
"arrowtooth flounder",NA,2009,232,3448,21,3469,0,956,"nwfsc_wcgbt"
"arrowtooth flounder",NA,2010,265,3697,6,3703,0,1134,"nwfsc_wcgbt"
"arrowtooth flounder",NA,2011,264,3057,3,3060,0,1043,"nwfsc_wcgbt"
"arrowtooth flounder",NA,2012,248,3027,18,3045,399,627,"nwfsc_wcgbt"
"arrowtooth flounder",NA,2013,184,2519,15,2534,400,285,"nwfsc_wcgbt"
"arrowtooth flounder",NA,2014,272,3526,124,3650,400,523,"nwfsc_wcgbt"
"arrowtooth flounder",NA,2015,277,3846,5,3851,400,567,"nwfsc_wcgbt"
"arrowtooth flounder",NA,2016,285,3257,0,3257,400,574,"nwfsc_wcgbt"
"arrowtooth flounder",NA,2017,266,2200,5,2205,0,862,"nwfsc_wcgbt"
"arrowtooth flounder",NA,2018,232,1761,0,1761,0,761,"nwfsc_wcgbt"
"arrowtooth flounder",NA,2019,123,754,0,754,0,376,"nwfsc_wcgbt"
"arrowtooth flounder",NA,2021,201,1342,27,1369,0,621,"nwfsc_wcgbt"
"aurora rockfish",NA,2003,67,1105,15,1120,404,155,"nwfsc_wcgbt"
"aurora rockfish",NA,2004,55,1087,0,1087,0,354,"nwfsc_wcgbt"
"aurora rockfish",NA,2005,89,1669,16,1685,428,139,"nwfsc_wcgbt"
"aurora rockfish",NA,2006,87,1713,3,1716,0,599,"nwfsc_wcgbt"
"aurora rockfish",NA,2007,92,1679,15,1694,395,191,"nwfsc_wcgbt"
"aurora rockfish",NA,2008,118,1702,6,1708,0,706,"nwfsc_wcgbt"
"aurora rockfish",NA,2009,87,1889,8,1897,403,184,"nwfsc_wcgbt"
"aurora rockfish",NA,2010,91,1605,29,1634,487,318,"nwfsc_wcgbt"
"aurora rockfish",NA,2011,94,1481,41,1522,502,282,"nwfsc_wcgbt"
"aurora rockfish",NA,2012,101,1659,25,1684,470,408,"nwfsc_wcgbt"
"aurora rockfish",NA,2013,58,849,2,851,0,515,"nwfsc_wcgbt"
"aurora rockfish",NA,2014,83,1489,8,1497,0,665,"nwfsc_wcgbt"
"aurora rockfish",NA,2015,89,2050,9,2059,0,793,"nwfsc_wcgbt"
"aurora rockfish",NA,2016,91,1947,26,1973,0,944,"nwfsc_wcgbt"
"aurora rockfish",NA,2017,90,2062,8,2070,0,843,"nwfsc_wcgbt"
"aurora rockfish",NA,2018,100,1756,3,1759,0,906,"nwfsc_wcgbt"
"aurora rockfish",NA,2019,36,629,1,630,0,332,"nwfsc_wcgbt"
"aurora rockfish",NA,2021,89,1545,9,1554,0,780,"nwfsc_wcgbt"
"bank rockfish",NA,2003,4,6,0,6,0,4,"nwfsc_wcgbt"
"bank rockfish",NA,2004,8,106,0,106,0,60,"nwfsc_wcgbt"
"bank rockfish",NA,2005,11,70,26,96,0,50,"nwfsc_wcgbt"
"bank rockfish",NA,2006,11,255,0,255,0,62,"nwfsc_wcgbt"
"bank rockfish",NA,2007,14,59,16,75,0,55,"nwfsc_wcgbt"
"bank rockfish",NA,2008,17,31,0,31,0,31,"nwfsc_wcgbt"
"bank rockfish",NA,2009,12,82,2,84,0,74,"nwfsc_wcgbt"
"bank rockfish",NA,2010,13,169,1,170,0,71,"nwfsc_wcgbt"
"bank rockfish",NA,2011,16,134,4,138,0,52,"nwfsc_wcgbt"
"bank rockfish",NA,2012,9,31,0,31,0,30,"nwfsc_wcgbt"
"bank rockfish",NA,2013,14,32,0,32,0,32,"nwfsc_wcgbt"
"bank rockfish",NA,2014,18,142,3,145,0,111,"nwfsc_wcgbt"
"bank rockfish",NA,2015,18,60,0,60,0,60,"nwfsc_wcgbt"
"bank rockfish",NA,2016,16,68,132,200,0,155,"nwfsc_wcgbt"
"bank rockfish",NA,2017,14,39,0,39,0,39,"nwfsc_wcgbt"
"bank rockfish",NA,2018,13,295,16,311,0,187,"nwfsc_wcgbt"
"bank rockfish",NA,2019,6,243,2,245,0,222,"nwfsc_wcgbt"
"bank rockfish",NA,2021,7,24,0,24,0,24,"nwfsc_wcgbt"
"big skate",NA,2003,60,195,2,197,0,0,"nwfsc_wcgbt"
"big skate",NA,2004,81,259,3,262,0,0,"nwfsc_wcgbt"
"big skate",NA,2005,99,328,0,328,0,0,"nwfsc_wcgbt"
"big skate",NA,2006,67,0,0,0,0,0,"nwfsc_wcgbt"
"big skate",NA,2007,76,95,0,95,0,0,"nwfsc_wcgbt"
"big skate",NA,2008,53,159,0,159,0,0,"nwfsc_wcgbt"
"big skate",NA,2009,82,302,3,305,230,0,"nwfsc_wcgbt"
"big skate",NA,2010,130,466,0,466,333,3,"nwfsc_wcgbt"
"big skate",NA,2011,99,360,0,360,0,0,"nwfsc_wcgbt"
"big skate",NA,2012,104,395,0,395,0,0,"nwfsc_wcgbt"
"big skate",NA,2013,84,316,0,316,0,0,"nwfsc_wcgbt"
"big skate",NA,2014,149,552,0,552,0,0,"nwfsc_wcgbt"
"big skate",NA,2015,135,546,0,546,0,0,"nwfsc_wcgbt"
"big skate",NA,2016,105,422,0,422,138,2,"nwfsc_wcgbt"
"big skate",NA,2017,125,496,0,496,164,23,"nwfsc_wcgbt"
"big skate",NA,2018,123,331,0,331,169,2,"nwfsc_wcgbt"
"big skate",NA,2019,56,180,0,180,0,82,"nwfsc_wcgbt"
"big skate",NA,2021,92,334,0,334,0,139,"nwfsc_wcgbt"
"black rockfish",NA,2004,1,1,0,1,0,1,"nwfsc_wcgbt"
"black rockfish",NA,2009,2,2,0,2,0,2,"nwfsc_wcgbt"
"black rockfish",NA,2010,1,1,0,1,0,1,"nwfsc_wcgbt"
"black rockfish",NA,2015,1,1,0,1,0,1,"nwfsc_wcgbt"
"black rockfish",NA,2016,1,1,0,1,0,1,"nwfsc_wcgbt"
"black rockfish",NA,2017,2,3,0,3,0,3,"nwfsc_wcgbt"
"black rockfish",NA,2019,1,1,0,1,0,1,"nwfsc_wcgbt"
"black rockfish",NA,2021,1,6,0,6,0,6,"nwfsc_wcgbt"
"blackgill rockfish",NA,2003,21,129,0,129,0,89,"nwfsc_wcgbt"
"blackgill rockfish",NA,2004,20,449,0,449,0,175,"nwfsc_wcgbt"
"blackgill rockfish",NA,2005,28,397,1,398,0,191,"nwfsc_wcgbt"
"blackgill rockfish",NA,2006,35,750,2,752,0,200,"nwfsc_wcgbt"
"blackgill rockfish",NA,2007,29,298,0,298,0,194,"nwfsc_wcgbt"
"blackgill rockfish",NA,2008,44,339,0,339,0,243,"nwfsc_wcgbt"
"blackgill rockfish",NA,2009,40,535,18,553,0,430,"nwfsc_wcgbt"
"blackgill rockfish",NA,2010,43,514,8,522,0,461,"nwfsc_wcgbt"
"blackgill rockfish",NA,2011,44,362,3,365,311,0,"nwfsc_wcgbt"
"blackgill rockfish",NA,2012,43,503,5,508,419,0,"nwfsc_wcgbt"
"blackgill rockfish",NA,2013,31,415,4,419,0,348,"nwfsc_wcgbt"
"blackgill rockfish",NA,2014,38,847,7,854,638,0,"nwfsc_wcgbt"
"blackgill rockfish",NA,2015,39,717,2,719,580,0,"nwfsc_wcgbt"
"blackgill rockfish",NA,2016,34,379,0,379,0,361,"nwfsc_wcgbt"
"blackgill rockfish",NA,2017,38,594,2,596,0,442,"nwfsc_wcgbt"
"blackgill rockfish",NA,2018,44,968,2,970,0,693,"nwfsc_wcgbt"
"blackgill rockfish",NA,2019,16,239,1,240,0,226,"nwfsc_wcgbt"
"blackgill rockfish",NA,2021,39,606,0,606,0,423,"nwfsc_wcgbt"
"blue and deacon rockfish",NA,2003,2,19,0,19,0,0,"nwfsc_wcgbt"
"blue and deacon rockfish",NA,2008,1,2,0,2,0,2,"nwfsc_wcgbt"
"blue and deacon rockfish",NA,2013,3,3,0,3,0,3,"nwfsc_wcgbt"
"blue and deacon rockfish",NA,2016,1,13,0,13,0,13,"nwfsc_wcgbt"
"blue and deacon rockfish",NA,2019,1,12,0,12,0,9,"nwfsc_wcgbt"
"bocaccio",NA,2003,38,102,5,107,105,2,"nwfsc_wcgbt"
"bocaccio",NA,2004,29,480,0,480,209,0,"nwfsc_wcgbt"
"bocaccio",NA,2005,40,270,0,270,146,1,"nwfsc_wcgbt"
"bocaccio",NA,2006,38,262,0,262,127,8,"nwfsc_wcgbt"
"bocaccio",NA,2007,30,157,0,157,94,4,"nwfsc_wcgbt"
"bocaccio",NA,2008,25,109,1,110,85,0,"nwfsc_wcgbt"
"bocaccio",NA,2009,24,100,0,100,95,5,"nwfsc_wcgbt"
"bocaccio",NA,2010,37,162,110,272,188,1,"nwfsc_wcgbt"
"bocaccio",NA,2011,22,105,0,105,105,0,"nwfsc_wcgbt"
"bocaccio",NA,2012,48,816,1,817,513,3,"nwfsc_wcgbt"
"bocaccio",NA,2013,46,539,199,738,493,2,"nwfsc_wcgbt"
"bocaccio",NA,2014,97,995,25,1020,695,16,"nwfsc_wcgbt"
"bocaccio",NA,2015,58,687,9,696,0,383,"nwfsc_wcgbt"
"bocaccio",NA,2016,81,1338,109,1447,0,695,"nwfsc_wcgbt"
"bocaccio",NA,2017,74,952,0,952,0,621,"nwfsc_wcgbt"
"bocaccio",NA,2018,76,806,0,806,0,601,"nwfsc_wcgbt"
"bocaccio",NA,2019,42,539,0,539,0,383,"nwfsc_wcgbt"
"bocaccio",NA,2021,92,654,8,662,0,538,"nwfsc_wcgbt"
"brown rockfish",NA,2003,8,46,2,48,0,0,"nwfsc_wcgbt"
"brown rockfish",NA,2004,6,28,0,28,0,28,"nwfsc_wcgbt"
"brown rockfish",NA,2005,5,42,1,43,0,20,"nwfsc_wcgbt"
"brown rockfish",NA,2006,4,13,0,13,0,13,"nwfsc_wcgbt"
"brown rockfish",NA,2007,1,1,0,1,0,1,"nwfsc_wcgbt"
"brown rockfish",NA,2008,2,3,1,4,0,4,"nwfsc_wcgbt"
"brown rockfish",NA,2009,2,9,0,9,0,9,"nwfsc_wcgbt"
"brown rockfish",NA,2010,3,15,0,15,0,14,"nwfsc_wcgbt"
"brown rockfish",NA,2011,7,13,2,15,0,15,"nwfsc_wcgbt"
"brown rockfish",NA,2012,8,39,0,39,0,29,"nwfsc_wcgbt"
"brown rockfish",NA,2013,4,39,0,39,0,30,"nwfsc_wcgbt"
"brown rockfish",NA,2014,5,83,0,83,0,37,"nwfsc_wcgbt"
"brown rockfish",NA,2015,7,51,0,51,0,50,"nwfsc_wcgbt"
"brown rockfish",NA,2016,6,7,0,7,0,7,"nwfsc_wcgbt"
"brown rockfish",NA,2017,6,35,0,35,0,35,"nwfsc_wcgbt"
"brown rockfish",NA,2018,12,62,0,62,0,62,"nwfsc_wcgbt"
"brown rockfish",NA,2019,4,32,0,32,0,32,"nwfsc_wcgbt"
"brown rockfish",NA,2021,9,26,0,26,0,26,"nwfsc_wcgbt"
"cabezon",NA,2008,1,1,0,1,0,1,"nwfsc_wcgbt"
"cabezon",NA,2016,1,0,1,1,0,0,"nwfsc_wcgbt"
"cabezon",NA,2017,1,1,0,1,0,1,"nwfsc_wcgbt"
"cabezon",NA,2018,1,1,0,1,0,1,"nwfsc_wcgbt"
"california scorpionfish",NA,2003,7,69,5,74,0,0,"nwfsc_wcgbt"
"california scorpionfish",NA,2004,12,115,41,156,0,0,"nwfsc_wcgbt"
"california scorpionfish",NA,2005,8,169,0,169,75,0,"nwfsc_wcgbt"
"california scorpionfish",NA,2006,11,46,1,47,45,1,"nwfsc_wcgbt"
"california scorpionfish",NA,2007,12,191,0,191,68,0,"nwfsc_wcgbt"
"california scorpionfish",NA,2008,12,50,0,50,49,1,"nwfsc_wcgbt"
"california scorpionfish",NA,2009,11,346,1,347,130,0,"nwfsc_wcgbt"
"california scorpionfish",NA,2010,10,58,0,58,42,0,"nwfsc_wcgbt"
"california scorpionfish",NA,2011,16,239,0,239,116,1,"nwfsc_wcgbt"
"california scorpionfish",NA,2012,9,94,0,94,66,0,"nwfsc_wcgbt"
"california scorpionfish",NA,2013,7,259,0,259,67,0,"nwfsc_wcgbt"
"california scorpionfish",NA,2014,6,91,2,93,73,0,"nwfsc_wcgbt"
"california scorpionfish",NA,2015,14,160,3,163,57,1,"nwfsc_wcgbt"
"california scorpionfish",NA,2016,12,127,12,139,95,2,"nwfsc_wcgbt"
"california scorpionfish",NA,2017,13,275,34,309,0,140,"nwfsc_wcgbt"
"california scorpionfish",NA,2018,23,287,2,289,0,128,"nwfsc_wcgbt"
"california scorpionfish",NA,2019,13,215,0,215,0,88,"nwfsc_wcgbt"
"california scorpionfish",NA,2021,24,334,1,335,0,211,"nwfsc_wcgbt"
"canary rockfish",NA,2003,50,423,0,423,262,16,"nwfsc_wcgbt"
"canary rockfish",NA,2004,37,482,0,482,254,1,"nwfsc_wcgbt"
"canary rockfish",NA,2005,53,529,1,530,231,0,"nwfsc_wcgbt"
"canary rockfish",NA,2006,32,622,1,623,247,0,"nwfsc_wcgbt"
"canary rockfish",NA,2007,48,672,1,673,497,0,"nwfsc_wcgbt"
"canary rockfish",NA,2008,35,701,91,792,452,0,"nwfsc_wcgbt"
"canary rockfish",NA,2009,32,301,5,306,239,1,"nwfsc_wcgbt"
"canary rockfish",NA,2010,51,432,63,495,397,0,"nwfsc_wcgbt"
"canary rockfish",NA,2011,45,569,4,573,364,1,"nwfsc_wcgbt"
"canary rockfish",NA,2012,56,799,53,852,596,1,"nwfsc_wcgbt"
"canary rockfish",NA,2013,38,480,32,512,376,1,"nwfsc_wcgbt"
"canary rockfish",NA,2014,75,1457,10,1467,901,9,"nwfsc_wcgbt"
"canary rockfish",NA,2015,77,1061,3,1064,0,738,"nwfsc_wcgbt"
"canary rockfish",NA,2016,80,1046,9,1055,605,0,"nwfsc_wcgbt"
"canary rockfish",NA,2017,84,955,15,970,0,528,"nwfsc_wcgbt"
"canary rockfish",NA,2018,65,716,3,719,0,475,"nwfsc_wcgbt"
"canary rockfish",NA,2019,40,544,0,544,0,360,"nwfsc_wcgbt"
"canary rockfish",NA,2021,52,417,113,530,0,418,"nwfsc_wcgbt"
"chilipepper",NA,2003,85,2472,136,2608,677,17,"nwfsc_wcgbt"
"chilipepper",NA,2004,80,3214,251,3465,758,5,"nwfsc_wcgbt"
"chilipepper",NA,2005,86,3576,128,3704,833,1,"nwfsc_wcgbt"
"chilipepper",NA,2006,70,2630,66,2696,611,0,"nwfsc_wcgbt"
"chilipepper",NA,2007,68,2472,23,2495,590,1,"nwfsc_wcgbt"
"chilipepper",NA,2008,80,2192,17,2209,698,2,"nwfsc_wcgbt"
"chilipepper",NA,2009,79,1757,358,2115,619,0,"nwfsc_wcgbt"
"chilipepper",NA,2010,106,1666,425,2091,806,15,"nwfsc_wcgbt"
"chilipepper",NA,2011,81,980,78,1058,647,2,"nwfsc_wcgbt"
"chilipepper",NA,2012,102,1145,132,1277,847,0,"nwfsc_wcgbt"
"chilipepper",NA,2013,94,891,193,1084,684,0,"nwfsc_wcgbt"
"chilipepper",NA,2014,126,1619,121,1740,884,2,"nwfsc_wcgbt"
"chilipepper",NA,2015,103,912,140,1052,0,619,"nwfsc_wcgbt"
"chilipepper",NA,2016,111,1176,269,1445,0,720,"nwfsc_wcgbt"
"chilipepper",NA,2017,93,867,38,905,0,540,"nwfsc_wcgbt"
"chilipepper",NA,2018,94,980,7,987,0,530,"nwfsc_wcgbt"
"chilipepper",NA,2019,52,658,1,659,0,350,"nwfsc_wcgbt"
"chilipepper",NA,2021,127,1022,361,1383,0,770,"nwfsc_wcgbt"
"copper rockfish",NA,2003,7,25,0,25,0,0,"nwfsc_wcgbt"
"copper rockfish",NA,2004,5,71,0,71,20,51,"nwfsc_wcgbt"
"copper rockfish",NA,2005,5,19,3,22,1,21,"nwfsc_wcgbt"
"copper rockfish",NA,2006,3,10,0,10,2,8,"nwfsc_wcgbt"
"copper rockfish",NA,2007,5,13,0,13,8,5,"nwfsc_wcgbt"
"copper rockfish",NA,2008,11,44,0,44,14,30,"nwfsc_wcgbt"
"copper rockfish",NA,2009,7,27,0,27,20,7,"nwfsc_wcgbt"
"copper rockfish",NA,2010,10,17,1,18,1,17,"nwfsc_wcgbt"
"copper rockfish",NA,2011,4,12,0,12,9,3,"nwfsc_wcgbt"
"copper rockfish",NA,2012,19,234,7,241,42,61,"nwfsc_wcgbt"
"copper rockfish",NA,2013,9,98,0,98,2,32,"nwfsc_wcgbt"
"copper rockfish",NA,2014,8,40,0,40,4,29,"nwfsc_wcgbt"
"copper rockfish",NA,2015,9,111,2,113,16,23,"nwfsc_wcgbt"
"copper rockfish",NA,2016,9,53,43,96,28,49,"nwfsc_wcgbt"
"copper rockfish",NA,2017,12,125,1,126,20,82,"nwfsc_wcgbt"
"copper rockfish",NA,2018,11,62,0,62,0,53,"nwfsc_wcgbt"
"copper rockfish",NA,2019,7,32,0,32,0,32,"nwfsc_wcgbt"
"copper rockfish",NA,2021,17,91,1,92,0,92,"nwfsc_wcgbt"
"cowcod",NA,2003,7,13,0,13,13,0,"nwfsc_wcgbt"
"cowcod",NA,2004,20,64,0,64,24,40,"nwfsc_wcgbt"
"cowcod",NA,2005,21,27,3,30,25,5,"nwfsc_wcgbt"
"cowcod",NA,2006,11,25,0,25,25,0,"nwfsc_wcgbt"
"cowcod",NA,2007,9,25,0,25,21,4,"nwfsc_wcgbt"
"cowcod",NA,2008,11,13,3,16,16,0,"nwfsc_wcgbt"
"cowcod",NA,2009,14,20,3,23,22,1,"nwfsc_wcgbt"
"cowcod",NA,2010,29,45,15,60,58,2,"nwfsc_wcgbt"
"cowcod",NA,2011,20,26,3,29,29,0,"nwfsc_wcgbt"
"cowcod",NA,2012,24,72,1,73,73,0,"nwfsc_wcgbt"
"cowcod",NA,2013,12,15,11,26,23,1,"nwfsc_wcgbt"
"cowcod",NA,2014,22,74,3,77,75,2,"nwfsc_wcgbt"
"cowcod",NA,2015,17,30,0,30,30,0,"nwfsc_wcgbt"
"cowcod",NA,2016,32,62,3,65,0,65,"nwfsc_wcgbt"
"cowcod",NA,2017,17,31,3,34,34,0,"nwfsc_wcgbt"
"cowcod",NA,2018,32,113,3,116,0,107,"nwfsc_wcgbt"
"cowcod",NA,2019,16,89,0,89,0,89,"nwfsc_wcgbt"
"cowcod",NA,2021,20,31,2,33,0,33,"nwfsc_wcgbt"
"curlfin sole",NA,2003,55,556,1,557,0,0,"nwfsc_wcgbt"
"curlfin sole",NA,2004,49,546,1,547,0,0,"nwfsc_wcgbt"
"curlfin sole",NA,2005,69,439,0,439,0,0,"nwfsc_wcgbt"
"curlfin sole",NA,2006,42,288,1,289,0,0,"nwfsc_wcgbt"
"curlfin sole",NA,2007,47,180,0,180,0,0,"nwfsc_wcgbt"
"curlfin sole",NA,2008,60,294,2,296,0,262,"nwfsc_wcgbt"
"curlfin sole",NA,2009,76,302,0,302,0,297,"nwfsc_wcgbt"
"curlfin sole",NA,2010,64,317,0,317,0,0,"nwfsc_wcgbt"
"curlfin sole",NA,2011,86,505,1,506,0,0,"nwfsc_wcgbt"
"curlfin sole",NA,2012,108,1018,1,1019,0,0,"nwfsc_wcgbt"
"curlfin sole",NA,2013,73,777,0,777,0,0,"nwfsc_wcgbt"
"curlfin sole",NA,2014,96,1182,1,1183,0,0,"nwfsc_wcgbt"
"curlfin sole",NA,2015,97,835,2,837,0,359,"nwfsc_wcgbt"
"curlfin sole",NA,2016,99,806,14,820,0,344,"nwfsc_wcgbt"
"curlfin sole",NA,2017,89,597,5,602,0,0,"nwfsc_wcgbt"
"curlfin sole",NA,2018,86,482,0,482,0,0,"nwfsc_wcgbt"
"curlfin sole",NA,2019,33,179,0,179,0,104,"nwfsc_wcgbt"
"curlfin sole",NA,2021,81,476,0,476,0,245,"nwfsc_wcgbt"
"darkblotched rockfish",NA,2003,100,2371,4,2375,748,24,"nwfsc_wcgbt"
"darkblotched rockfish",NA,2004,90,1055,7,1062,595,0,"nwfsc_wcgbt"
"darkblotched rockfish",NA,2005,110,1972,11,1983,804,0,"nwfsc_wcgbt"
"darkblotched rockfish",NA,2006,130,1910,15,1925,940,4,"nwfsc_wcgbt"
"darkblotched rockfish",NA,2007,132,2060,26,2086,987,0,"nwfsc_wcgbt"
"darkblotched rockfish",NA,2008,111,1632,15,1647,762,0,"nwfsc_wcgbt"
"darkblotched rockfish",NA,2009,126,2268,30,2298,1159,0,"nwfsc_wcgbt"
"darkblotched rockfish",NA,2010,117,2224,15,2239,912,0,"nwfsc_wcgbt"
"darkblotched rockfish",NA,2011,108,1824,4,1828,796,2,"nwfsc_wcgbt"
"darkblotched rockfish",NA,2012,102,2166,39,2205,791,2,"nwfsc_wcgbt"
"darkblotched rockfish",NA,2013,89,1543,5,1548,687,3,"nwfsc_wcgbt"
"darkblotched rockfish",NA,2014,114,1420,97,1517,767,0,"nwfsc_wcgbt"
"darkblotched rockfish",NA,2015,132,2391,67,2458,1066,2,"nwfsc_wcgbt"
"darkblotched rockfish",NA,2016,118,2094,3,2097,713,1,"nwfsc_wcgbt"
"darkblotched rockfish",NA,2017,124,1696,34,1730,0,669,"nwfsc_wcgbt"
"darkblotched rockfish",NA,2018,105,1268,1,1269,0,585,"nwfsc_wcgbt"
"darkblotched rockfish",NA,2019,57,822,0,822,0,329,"nwfsc_wcgbt"
"darkblotched rockfish",NA,2021,122,1017,101,1118,0,622,"nwfsc_wcgbt"
"dover sole",NA,2003,440,22866,32,22898,957,2024,"nwfsc_wcgbt"
"dover sole",NA,2004,402,17309,40,17349,952,1546,"nwfsc_wcgbt"
"dover sole",NA,2005,547,17659,5,17664,989,1513,"nwfsc_wcgbt"
"dover sole",NA,2006,528,13496,23,13519,970,1011,"nwfsc_wcgbt"
"dover sole",NA,2007,577,11255,10,11265,984,1157,"nwfsc_wcgbt"
"dover sole",NA,2008,553,6230,4,6234,948,124,"nwfsc_wcgbt"
"dover sole",NA,2009,541,3566,7,3573,1034,20,"nwfsc_wcgbt"
"dover sole",NA,2010,600,3206,33,3239,996,176,"nwfsc_wcgbt"
"dover sole",NA,2011,570,8396,27,8423,1075,10,"nwfsc_wcgbt"
"dover sole",NA,2012,559,8761,15,8776,1088,6,"nwfsc_wcgbt"
"dover sole",NA,2013,413,7316,12,7328,809,9,"nwfsc_wcgbt"
"dover sole",NA,2014,576,10152,25,10177,1123,7,"nwfsc_wcgbt"
"dover sole",NA,2015,567,10010,60,10070,1088,9,"nwfsc_wcgbt"
"dover sole",NA,2016,580,10126,34,10160,1120,6,"nwfsc_wcgbt"
"dover sole",NA,2017,586,6210,13,6223,1141,15,"nwfsc_wcgbt"
"dover sole",NA,2018,592,6015,16,6031,1161,5,"nwfsc_wcgbt"
"dover sole",NA,2019,291,3033,1,3034,487,79,"nwfsc_wcgbt"
"dover sole",NA,2021,576,5613,4,5617,0,1118,"nwfsc_wcgbt"
"english sole",NA,2003,221,8124,0,8124,182,1584,"nwfsc_wcgbt"
"english sole",NA,2004,210,8206,4,8210,360,563,"nwfsc_wcgbt"
"english sole",NA,2005,286,8366,0,8366,356,873,"nwfsc_wcgbt"
"english sole",NA,2006,229,5383,6,5389,0,980,"nwfsc_wcgbt"
"english sole",NA,2007,239,3935,10,3945,0,926,"nwfsc_wcgbt"
"english sole",NA,2008,235,3477,1,3478,0,834,"nwfsc_wcgbt"
"english sole",NA,2009,242,3346,21,3367,0,893,"nwfsc_wcgbt"
"english sole",NA,2010,286,2476,1,2477,0,1046,"nwfsc_wcgbt"
"english sole",NA,2011,299,4448,6,4454,0,1062,"nwfsc_wcgbt"
"english sole",NA,2012,299,4637,0,4637,0,1078,"nwfsc_wcgbt"
"english sole",NA,2013,204,3542,3,3545,0,748,"nwfsc_wcgbt"
"english sole",NA,2014,311,5241,1,5242,0,1138,"nwfsc_wcgbt"
"english sole",NA,2015,305,5105,0,5105,0,1091,"nwfsc_wcgbt"
"english sole",NA,2016,310,5223,0,5223,0,622,"nwfsc_wcgbt"
"english sole",NA,2017,321,3542,7,3549,0,623,"nwfsc_wcgbt"
"english sole",NA,2018,285,2914,1,2915,0,559,"nwfsc_wcgbt"
"english sole",NA,2019,148,1413,0,1413,0,282,"nwfsc_wcgbt"
"english sole",NA,2021,295,2654,0,2654,0,577,"nwfsc_wcgbt"
"flag rockfish",NA,2003,6,77,0,77,0,0,"nwfsc_wcgbt"
"flag rockfish",NA,2004,8,14,0,14,0,14,"nwfsc_wcgbt"
"flag rockfish",NA,2005,5,6,1,7,0,7,"nwfsc_wcgbt"
"flag rockfish",NA,2006,9,25,0,25,0,25,"nwfsc_wcgbt"
"flag rockfish",NA,2007,13,54,1,55,0,49,"nwfsc_wcgbt"
"flag rockfish",NA,2008,8,8,0,8,0,8,"nwfsc_wcgbt"
"flag rockfish",NA,2009,11,29,1,30,3,27,"nwfsc_wcgbt"
"flag rockfish",NA,2010,8,16,0,16,0,16,"nwfsc_wcgbt"
"flag rockfish",NA,2011,4,5,0,5,0,5,"nwfsc_wcgbt"
"flag rockfish",NA,2012,6,69,0,69,0,35,"nwfsc_wcgbt"
"flag rockfish",NA,2013,4,11,0,11,0,11,"nwfsc_wcgbt"
"flag rockfish",NA,2014,5,19,0,19,0,19,"nwfsc_wcgbt"
"flag rockfish",NA,2015,5,18,0,18,0,17,"nwfsc_wcgbt"
"flag rockfish",NA,2016,8,11,1,12,0,12,"nwfsc_wcgbt"
"flag rockfish",NA,2017,7,36,0,36,0,29,"nwfsc_wcgbt"
"flag rockfish",NA,2018,9,34,0,34,0,34,"nwfsc_wcgbt"
"flag rockfish",NA,2019,3,19,0,19,0,19,"nwfsc_wcgbt"
"flag rockfish",NA,2021,1,1,0,1,0,1,"nwfsc_wcgbt"
"flathead sole",NA,2003,52,1521,0,1521,0,0,"nwfsc_wcgbt"
"flathead sole",NA,2004,41,507,0,507,0,0,"nwfsc_wcgbt"
"flathead sole",NA,2005,42,593,0,593,0,0,"nwfsc_wcgbt"
"flathead sole",NA,2006,50,421,0,421,0,0,"nwfsc_wcgbt"
"flathead sole",NA,2007,27,137,0,137,0,0,"nwfsc_wcgbt"
"flathead sole",NA,2008,25,156,1,157,0,0,"nwfsc_wcgbt"
"flathead sole",NA,2009,38,191,0,191,0,0,"nwfsc_wcgbt"
"flathead sole",NA,2010,55,393,13,406,0,0,"nwfsc_wcgbt"
"flathead sole",NA,2011,52,549,5,554,0,203,"nwfsc_wcgbt"
"flathead sole",NA,2012,49,253,3,256,0,136,"nwfsc_wcgbt"
"flathead sole",NA,2013,33,289,2,291,0,160,"nwfsc_wcgbt"
"flathead sole",NA,2014,77,945,35,980,0,519,"nwfsc_wcgbt"
"flathead sole",NA,2015,100,1649,5,1654,0,659,"nwfsc_wcgbt"
"flathead sole",NA,2016,75,1236,1,1237,0,517,"nwfsc_wcgbt"
"flathead sole",NA,2017,76,653,0,653,0,256,"nwfsc_wcgbt"
"flathead sole",NA,2018,65,515,1,516,0,229,"nwfsc_wcgbt"
"flathead sole",NA,2019,30,202,0,202,0,85,"nwfsc_wcgbt"
"flathead sole",NA,2021,48,314,2,316,0,189,"nwfsc_wcgbt"
"gopher rockfish",NA,2005,1,1,0,1,0,1,"nwfsc_wcgbt"
"gopher rockfish",NA,2006,2,2,0,2,0,2,"nwfsc_wcgbt"
"gopher rockfish",NA,2009,1,1,0,1,0,1,"nwfsc_wcgbt"
"gopher rockfish",NA,2010,2,3,0,3,0,3,"nwfsc_wcgbt"
"gopher rockfish",NA,2011,1,0,1,1,0,1,"nwfsc_wcgbt"
"gopher rockfish",NA,2012,4,3,2,5,0,3,"nwfsc_wcgbt"
"gopher rockfish",NA,2013,1,1,1,2,0,2,"nwfsc_wcgbt"
"gopher rockfish",NA,2017,1,0,1,1,0,1,"nwfsc_wcgbt"
"gopher rockfish",NA,2018,1,1,0,1,0,1,"nwfsc_wcgbt"
"greenspotted rockfish",NA,2003,33,420,0,420,0,0,"nwfsc_wcgbt"
"greenspotted rockfish",NA,2004,26,553,9,562,0,278,"nwfsc_wcgbt"
"greenspotted rockfish",NA,2005,29,216,9,225,85,42,"nwfsc_wcgbt"
"greenspotted rockfish",NA,2006,43,459,4,463,0,261,"nwfsc_wcgbt"
"greenspotted rockfish",NA,2007,40,622,31,653,265,42,"nwfsc_wcgbt"
"greenspotted rockfish",NA,2008,41,512,45,557,0,244,"nwfsc_wcgbt"
"greenspotted rockfish",NA,2009,49,650,28,678,351,26,"nwfsc_wcgbt"
"greenspotted rockfish",NA,2010,37,670,41,711,0,395,"nwfsc_wcgbt"
"greenspotted rockfish",NA,2011,34,259,9,268,0,225,"nwfsc_wcgbt"
"greenspotted rockfish",NA,2012,35,393,8,401,0,235,"nwfsc_wcgbt"
"greenspotted rockfish",NA,2013,25,245,1,246,0,218,"nwfsc_wcgbt"
"greenspotted rockfish",NA,2014,36,290,6,296,0,221,"nwfsc_wcgbt"
"greenspotted rockfish",NA,2015,26,243,6,249,0,209,"nwfsc_wcgbt"
"greenspotted rockfish",NA,2016,40,883,16,899,0,464,"nwfsc_wcgbt"
"greenspotted rockfish",NA,2017,28,333,1,334,0,213,"nwfsc_wcgbt"
"greenspotted rockfish",NA,2018,36,377,21,398,0,322,"nwfsc_wcgbt"
"greenspotted rockfish",NA,2019,17,207,1,208,0,164,"nwfsc_wcgbt"
"greenspotted rockfish",NA,2021,46,344,10,354,0,320,"nwfsc_wcgbt"
"greenstriped rockfish",NA,2003,131,3489,37,3526,577,33,"nwfsc_wcgbt"
"greenstriped rockfish",NA,2004,136,2654,13,2667,522,7,"nwfsc_wcgbt"
"greenstriped rockfish",NA,2005,175,3871,27,3898,568,131,"nwfsc_wcgbt"
"greenstriped rockfish",NA,2006,179,3116,16,3132,524,155,"nwfsc_wcgbt"
"greenstriped rockfish",NA,2007,167,2325,34,2359,657,5,"nwfsc_wcgbt"
"greenstriped rockfish",NA,2008,149,1805,60,1865,565,3,"nwfsc_wcgbt"
"greenstriped rockfish",NA,2009,164,1718,82,1800,0,614,"nwfsc_wcgbt"
"greenstriped rockfish",NA,2010,189,2156,166,2322,0,747,"nwfsc_wcgbt"
"greenstriped rockfish",NA,2011,184,1810,123,1933,0,646,"nwfsc_wcgbt"
"greenstriped rockfish",NA,2012,186,2099,117,2216,0,753,"nwfsc_wcgbt"
"greenstriped rockfish",NA,2013,125,1449,23,1472,0,494,"nwfsc_wcgbt"
"greenstriped rockfish",NA,2014,180,2259,15,2274,0,682,"nwfsc_wcgbt"
"greenstriped rockfish",NA,2015,174,1988,30,2018,0,693,"nwfsc_wcgbt"
"greenstriped rockfish",NA,2016,164,2302,17,2319,0,736,"nwfsc_wcgbt"
"greenstriped rockfish",NA,2017,169,1890,29,1919,0,646,"nwfsc_wcgbt"
"greenstriped rockfish",NA,2018,198,2395,82,2477,0,786,"nwfsc_wcgbt"
"greenstriped rockfish",NA,2019,96,1163,4,1167,0,382,"nwfsc_wcgbt"
"greenstriped rockfish",NA,2021,164,2009,8,2017,0,624,"nwfsc_wcgbt"
"honeycomb rockfish",NA,2003,1,1,0,1,0,0,"nwfsc_wcgbt"
"honeycomb rockfish",NA,2005,1,14,0,14,0,14,"nwfsc_wcgbt"
"honeycomb rockfish",NA,2006,2,14,0,14,0,14,"nwfsc_wcgbt"
"honeycomb rockfish",NA,2007,3,68,0,68,0,31,"nwfsc_wcgbt"
"honeycomb rockfish",NA,2008,1,1,0,1,0,1,"nwfsc_wcgbt"
"honeycomb rockfish",NA,2009,1,90,0,90,0,15,"nwfsc_wcgbt"
"honeycomb rockfish",NA,2010,1,22,0,22,0,22,"nwfsc_wcgbt"
"honeycomb rockfish",NA,2012,3,6,0,6,0,6,"nwfsc_wcgbt"
"honeycomb rockfish",NA,2013,3,36,0,36,0,36,"nwfsc_wcgbt"
"honeycomb rockfish",NA,2014,1,1,0,1,0,1,"nwfsc_wcgbt"
"honeycomb rockfish",NA,2016,1,2,2,4,0,4,"nwfsc_wcgbt"
"honeycomb rockfish",NA,2017,2,4,0,4,0,4,"nwfsc_wcgbt"
"honeycomb rockfish",NA,2018,1,14,0,14,0,14,"nwfsc_wcgbt"
"honeycomb rockfish",NA,2019,1,14,0,14,0,14,"nwfsc_wcgbt"
"honeycomb rockfish",NA,2021,3,7,0,7,0,7,"nwfsc_wcgbt"
"kelp greenling",NA,2003,10,61,0,61,0,0,"nwfsc_wcgbt"
"kelp greenling",NA,2004,12,97,0,97,0,0,"nwfsc_wcgbt"
"kelp greenling",NA,2005,9,42,0,42,0,41,"nwfsc_wcgbt"
"kelp greenling",NA,2006,7,23,0,23,0,23,"nwfsc_wcgbt"
"kelp greenling",NA,2007,7,39,0,39,0,39,"nwfsc_wcgbt"
"kelp greenling",NA,2008,4,19,0,19,0,19,"nwfsc_wcgbt"
"kelp greenling",NA,2009,9,27,0,27,0,27,"nwfsc_wcgbt"
"kelp greenling",NA,2010,16,46,0,46,0,46,"nwfsc_wcgbt"
"kelp greenling",NA,2011,21,105,0,105,0,103,"nwfsc_wcgbt"
"kelp greenling",NA,2012,11,28,0,28,0,27,"nwfsc_wcgbt"
"kelp greenling",NA,2013,14,25,1,26,0,26,"nwfsc_wcgbt"
"kelp greenling",NA,2014,14,42,0,42,0,39,"nwfsc_wcgbt"
"kelp greenling",NA,2015,8,38,0,38,0,37,"nwfsc_wcgbt"
"kelp greenling",NA,2016,10,80,0,80,0,72,"nwfsc_wcgbt"
"kelp greenling",NA,2017,13,49,0,49,0,45,"nwfsc_wcgbt"
"kelp greenling",NA,2018,16,72,0,72,0,68,"nwfsc_wcgbt"
"kelp greenling",NA,2019,2,6,0,6,0,6,"nwfsc_wcgbt"
"kelp greenling",NA,2021,10,32,0,32,0,32,"nwfsc_wcgbt"
"kelp rockfish",NA,2016,1,4,1,5,0,5,"nwfsc_wcgbt"
"lingcod",NA,2003,185,1244,86,1330,875,17,"nwfsc_wcgbt"
"lingcod",NA,2004,170,1343,24,1367,827,25,"nwfsc_wcgbt"
"lingcod",NA,2005,196,1067,30,1097,840,24,"nwfsc_wcgbt"
"lingcod",NA,2006,171,1011,1,1012,697,14,"nwfsc_wcgbt"
"lingcod",NA,2007,169,631,14,645,483,69,"nwfsc_wcgbt"
"lingcod",NA,2008,190,883,277,1160,838,19,"nwfsc_wcgbt"
"lingcod",NA,2009,221,933,174,1107,484,483,"nwfsc_wcgbt"
"lingcod",NA,2010,235,1623,307,1930,518,516,"nwfsc_wcgbt"
"lingcod",NA,2011,266,1768,85,1853,519,526,"nwfsc_wcgbt"
"lingcod",NA,2012,250,1940,247,2187,410,418,"nwfsc_wcgbt"
"lingcod",NA,2013,189,1295,48,1343,365,262,"nwfsc_wcgbt"
"lingcod",NA,2014,263,2855,69,2924,478,438,"nwfsc_wcgbt"
"lingcod",NA,2015,245,1787,51,1838,437,323,"nwfsc_wcgbt"
"lingcod",NA,2016,230,1716,37,1753,366,359,"nwfsc_wcgbt"
"lingcod",NA,2017,250,1565,60,1625,286,478,"nwfsc_wcgbt"
"lingcod",NA,2018,224,1537,17,1554,399,319,"nwfsc_wcgbt"
"lingcod",NA,2019,124,551,1,552,234,209,"nwfsc_wcgbt"
"lingcod",NA,2021,224,1375,98,1473,0,699,"nwfsc_wcgbt"
"longnose skate",NA,2003,289,2653,2,2655,0,0,"nwfsc_wcgbt"
"longnose skate",NA,2004,273,2598,1,2599,0,0,"nwfsc_wcgbt"
"longnose skate",NA,2005,382,3257,2,3259,0,0,"nwfsc_wcgbt"
"longnose skate",NA,2006,385,0,0,0,0,0,"nwfsc_wcgbt"
"longnose skate",NA,2007,413,860,1,861,0,0,"nwfsc_wcgbt"
"longnose skate",NA,2008,395,3383,0,3383,0,0,"nwfsc_wcgbt"
"longnose skate",NA,2009,364,3113,3,3116,0,0,"nwfsc_wcgbt"
"longnose skate",NA,2010,408,3462,0,3462,0,0,"nwfsc_wcgbt"
"longnose skate",NA,2011,423,2987,4,2991,321,104,"nwfsc_wcgbt"
"longnose skate",NA,2012,427,3647,3,3650,328,40,"nwfsc_wcgbt"
"longnose skate",NA,2013,297,2491,1,2492,0,0,"nwfsc_wcgbt"
"longnose skate",NA,2014,421,3722,0,3722,0,0,"nwfsc_wcgbt"
"longnose skate",NA,2015,429,4053,14,4067,0,0,"nwfsc_wcgbt"
"longnose skate",NA,2016,428,4003,1,4004,0,420,"nwfsc_wcgbt"
"longnose skate",NA,2017,437,3679,0,3679,0,442,"nwfsc_wcgbt"
"longnose skate",NA,2018,426,3610,0,3610,0,421,"nwfsc_wcgbt"
"longnose skate",NA,2019,223,1655,0,1655,0,220,"nwfsc_wcgbt"
"longnose skate",NA,2021,405,3224,0,3224,0,401,"nwfsc_wcgbt"
"longspine thornyhead",NA,2003,195,0,15475,15475,0,955,"nwfsc_wcgbt"
"longspine thornyhead",NA,2004,151,2790,8383,11173,0,742,"nwfsc_wcgbt"
"longspine thornyhead",NA,2005,228,9044,4486,13530,0,1103,"nwfsc_wcgbt"
"longspine thornyhead",NA,2006,237,6407,2674,9081,0,930,"nwfsc_wcgbt"
"longspine thornyhead",NA,2007,250,4567,1631,6198,0,958,"nwfsc_wcgbt"
"longspine thornyhead",NA,2008,261,2775,860,3635,0,989,"nwfsc_wcgbt"
"longspine thornyhead",NA,2009,242,2333,777,3110,0,956,"nwfsc_wcgbt"
"longspine thornyhead",NA,2010,264,2297,785,3082,0,1032,"nwfsc_wcgbt"
"longspine thornyhead",NA,2011,254,4074,1114,5188,0,1002,"nwfsc_wcgbt"
"longspine thornyhead",NA,2012,248,3572,1388,4960,0,980,"nwfsc_wcgbt"
"longspine thornyhead",NA,2013,162,2643,642,3285,0,621,"nwfsc_wcgbt"
"longspine thornyhead",NA,2014,240,3938,947,4885,0,922,"nwfsc_wcgbt"
"longspine thornyhead",NA,2015,238,4051,771,4822,0,919,"nwfsc_wcgbt"
"longspine thornyhead",NA,2016,245,3837,1026,4863,0,529,"nwfsc_wcgbt"
"longspine thornyhead",NA,2017,236,3912,728,4640,0,478,"nwfsc_wcgbt"
"longspine thornyhead",NA,2018,248,3841,1039,4880,0,495,"nwfsc_wcgbt"
"longspine thornyhead",NA,2019,112,1664,298,1962,0,221,"nwfsc_wcgbt"
"longspine thornyhead",NA,2021,226,3672,704,4376,0,447,"nwfsc_wcgbt"
"olive rockfish",NA,2004,1,1,0,1,0,1,"nwfsc_wcgbt"
"olive rockfish",NA,2016,1,1,0,1,0,1,"nwfsc_wcgbt"
"pacific cod",NA,2003,68,783,0,783,0,0,"nwfsc_wcgbt"
"pacific cod",NA,2004,46,290,0,290,0,0,"nwfsc_wcgbt"
"pacific cod",NA,2005,27,199,0,199,0,0,"nwfsc_wcgbt"
"pacific cod",NA,2006,15,166,0,166,0,0,"nwfsc_wcgbt"
"pacific cod",NA,2007,24,177,0,177,0,0,"nwfsc_wcgbt"
"pacific cod",NA,2008,19,72,0,72,0,0,"nwfsc_wcgbt"
"pacific cod",NA,2009,17,123,0,123,0,0,"nwfsc_wcgbt"
"pacific cod",NA,2010,48,404,0,404,0,221,"nwfsc_wcgbt"
"pacific cod",NA,2011,34,294,7,301,0,150,"nwfsc_wcgbt"
"pacific cod",NA,2012,21,154,0,154,0,89,"nwfsc_wcgbt"
"pacific cod",NA,2013,27,173,2,175,0,33,"nwfsc_wcgbt"
"pacific cod",NA,2014,39,240,0,240,0,185,"nwfsc_wcgbt"
"pacific cod",NA,2015,62,328,0,328,0,270,"nwfsc_wcgbt"
"pacific cod",NA,2016,31,231,0,231,0,148,"nwfsc_wcgbt"
"pacific cod",NA,2017,25,93,0,93,0,92,"nwfsc_wcgbt"
"pacific cod",NA,2018,10,45,0,45,0,45,"nwfsc_wcgbt"
"pacific cod",NA,2019,10,69,0,69,0,33,"nwfsc_wcgbt"
"pacific cod",NA,2021,7,24,0,24,0,24,"nwfsc_wcgbt"
"pacific ocean perch",NA,2003,46,1425,1,1426,432,2,"nwfsc_wcgbt"
"pacific ocean perch",NA,2004,34,565,0,565,219,0,"nwfsc_wcgbt"
"pacific ocean perch",NA,2005,38,525,1,526,257,0,"nwfsc_wcgbt"
"pacific ocean perch",NA,2006,33,659,0,659,254,1,"nwfsc_wcgbt"
"pacific ocean perch",NA,2007,50,627,1,628,439,0,"nwfsc_wcgbt"
"pacific ocean perch",NA,2008,39,505,34,539,328,0,"nwfsc_wcgbt"
"pacific ocean perch",NA,2009,46,435,36,471,331,2,"nwfsc_wcgbt"
"pacific ocean perch",NA,2010,53,903,4,907,579,0,"nwfsc_wcgbt"
"pacific ocean perch",NA,2011,53,849,72,921,674,3,"nwfsc_wcgbt"
"pacific ocean perch",NA,2012,50,1166,9,1175,0,699,"nwfsc_wcgbt"
"pacific ocean perch",NA,2013,45,730,2,732,199,354,"nwfsc_wcgbt"
"pacific ocean perch",NA,2014,52,902,89,991,626,0,"nwfsc_wcgbt"
"pacific ocean perch",NA,2015,69,1143,22,1165,840,5,"nwfsc_wcgbt"
"pacific ocean perch",NA,2016,50,1150,0,1150,703,67,"nwfsc_wcgbt"
"pacific ocean perch",NA,2017,56,968,8,976,0,778,"nwfsc_wcgbt"
"pacific ocean perch",NA,2018,40,642,6,648,0,537,"nwfsc_wcgbt"
"pacific ocean perch",NA,2019,19,345,0,345,0,291,"nwfsc_wcgbt"
"pacific ocean perch",NA,2021,59,632,189,821,0,819,"nwfsc_wcgbt"
"pacific sanddab",NA,2003,133,8853,74,8927,787,8,"nwfsc_wcgbt"
"pacific sanddab",NA,2004,165,10755,0,10755,1419,8,"nwfsc_wcgbt"
"pacific sanddab",NA,2005,219,10126,0,10126,993,14,"nwfsc_wcgbt"
"pacific sanddab",NA,2006,178,5902,2,5904,704,15,"nwfsc_wcgbt"
"pacific sanddab",NA,2007,190,4293,26,4319,725,10,"nwfsc_wcgbt"
"pacific sanddab",NA,2008,202,4527,9,4536,768,6,"nwfsc_wcgbt"
"pacific sanddab",NA,2009,216,2815,6,2821,0,813,"nwfsc_wcgbt"
"pacific sanddab",NA,2010,242,1501,11,1512,1018,133,"nwfsc_wcgbt"
"pacific sanddab",NA,2011,240,4486,90,4576,752,96,"nwfsc_wcgbt"
"pacific sanddab",NA,2012,241,4536,78,4614,820,106,"nwfsc_wcgbt"
"pacific sanddab",NA,2013,160,3275,52,3327,0,618,"nwfsc_wcgbt"
"pacific sanddab",NA,2014,242,4992,47,5039,0,929,"nwfsc_wcgbt"
"pacific sanddab",NA,2015,246,4992,34,5026,0,926,"nwfsc_wcgbt"
"pacific sanddab",NA,2016,223,4565,6,4571,0,463,"nwfsc_wcgbt"
"pacific sanddab",NA,2017,242,3057,6,3063,0,466,"nwfsc_wcgbt"
"pacific sanddab",NA,2018,225,2590,7,2597,0,436,"nwfsc_wcgbt"
"pacific sanddab",NA,2019,110,1230,5,1235,0,215,"nwfsc_wcgbt"
"pacific sanddab",NA,2021,234,2333,10,2343,0,460,"nwfsc_wcgbt"
"pacific spiny dogfish",NA,2003,178,3787,2,3789,0,673,"nwfsc_wcgbt"
"pacific spiny dogfish",NA,2004,160,2480,1,2481,0,540,"nwfsc_wcgbt"
"pacific spiny dogfish",NA,2005,251,3565,1,3566,0,864,"nwfsc_wcgbt"
"pacific spiny dogfish",NA,2006,224,3882,18,3900,0,786,"nwfsc_wcgbt"
"pacific spiny dogfish",NA,2007,224,2419,2,2421,0,749,"nwfsc_wcgbt"
"pacific spiny dogfish",NA,2008,249,2847,27,2874,0,887,"nwfsc_wcgbt"
"pacific spiny dogfish",NA,2009,205,1658,3,1661,0,632,"nwfsc_wcgbt"
"pacific spiny dogfish",NA,2010,226,1723,4,1727,591,440,"nwfsc_wcgbt"
"pacific spiny dogfish",NA,2011,200,1635,2,1637,0,639,"nwfsc_wcgbt"
"pacific spiny dogfish",NA,2012,173,1507,2,1509,0,563,"nwfsc_wcgbt"
"pacific spiny dogfish",NA,2013,95,613,0,613,0,287,"nwfsc_wcgbt"
"pacific spiny dogfish",NA,2014,154,1474,2,1476,0,470,"nwfsc_wcgbt"
"pacific spiny dogfish",NA,2015,145,669,1,670,0,350,"nwfsc_wcgbt"
"pacific spiny dogfish",NA,2016,119,771,0,771,0,291,"nwfsc_wcgbt"
"pacific spiny dogfish",NA,2017,100,532,0,532,0,223,"nwfsc_wcgbt"
"pacific spiny dogfish",NA,2018,135,774,0,774,0,330,"nwfsc_wcgbt"
"pacific spiny dogfish",NA,2019,65,489,0,489,0,187,"nwfsc_wcgbt"
"pacific spiny dogfish",NA,2021,119,755,0,755,0,308,"nwfsc_wcgbt"
"petrale sole",NA,2003,197,2833,4,2837,765,835,"nwfsc_wcgbt"
"petrale sole",NA,2004,212,3345,1,3346,723,1133,"nwfsc_wcgbt"
"petrale sole",NA,2005,278,4539,16,4555,752,1093,"nwfsc_wcgbt"
"petrale sole",NA,2006,247,3664,4,3668,774,201,"nwfsc_wcgbt"
"petrale sole",NA,2007,257,3403,6,3409,690,289,"nwfsc_wcgbt"
"petrale sole",NA,2008,257,3042,5,3047,746,279,"nwfsc_wcgbt"
"petrale sole",NA,2009,277,3385,2,3387,777,283,"nwfsc_wcgbt"
"petrale sole",NA,2010,325,6049,3,6052,801,593,"nwfsc_wcgbt"
"petrale sole",NA,2011,320,6172,4,6176,799,561,"nwfsc_wcgbt"
"petrale sole",NA,2012,295,5366,6,5372,777,510,"nwfsc_wcgbt"
"petrale sole",NA,2013,218,3440,5,3445,843,1,"nwfsc_wcgbt"
"petrale sole",NA,2014,332,4805,17,4822,766,472,"nwfsc_wcgbt"
"petrale sole",NA,2015,312,4232,4,4236,751,406,"nwfsc_wcgbt"
"petrale sole",NA,2016,309,4383,2,4385,893,23,"nwfsc_wcgbt"
"petrale sole",NA,2017,314,4260,1,4261,884,4,"nwfsc_wcgbt"
"petrale sole",NA,2018,291,3782,1,3783,810,6,"nwfsc_wcgbt"
"petrale sole",NA,2019,155,1795,2,1797,0,624,"nwfsc_wcgbt"
"petrale sole",NA,2021,290,3727,2,3729,0,1233,"nwfsc_wcgbt"
"quillback rockfish",NA,2003,2,3,0,3,0,0,"nwfsc_wcgbt"
"quillback rockfish",NA,2005,2,2,0,2,2,0,"nwfsc_wcgbt"
"quillback rockfish",NA,2006,2,3,0,3,3,0,"nwfsc_wcgbt"
"quillback rockfish",NA,2007,2,20,0,20,16,0,"nwfsc_wcgbt"
"quillback rockfish",NA,2008,3,37,0,37,22,0,"nwfsc_wcgbt"
"quillback rockfish",NA,2009,2,3,0,3,3,0,"nwfsc_wcgbt"
"quillback rockfish",NA,2010,2,2,0,2,2,0,"nwfsc_wcgbt"
"quillback rockfish",NA,2011,4,6,0,6,6,0,"nwfsc_wcgbt"
"quillback rockfish",NA,2012,4,46,0,46,26,0,"nwfsc_wcgbt"
"quillback rockfish",NA,2013,2,1,1,2,1,0,"nwfsc_wcgbt"
"quillback rockfish",NA,2014,9,25,0,25,24,1,"nwfsc_wcgbt"
"quillback rockfish",NA,2015,6,7,1,8,8,0,"nwfsc_wcgbt"
"quillback rockfish",NA,2016,4,9,0,9,9,0,"nwfsc_wcgbt"
"quillback rockfish",NA,2017,7,15,1,16,16,0,"nwfsc_wcgbt"
"quillback rockfish",NA,2018,8,21,0,21,21,0,"nwfsc_wcgbt"
"quillback rockfish",NA,2019,3,16,0,16,16,0,"nwfsc_wcgbt"
"quillback rockfish",NA,2021,6,12,0,12,0,12,"nwfsc_wcgbt"
"redbanded rockfish",NA,2003,62,272,0,272,0,179,"nwfsc_wcgbt"
"redbanded rockfish",NA,2004,36,156,2,158,0,144,"nwfsc_wcgbt"
"redbanded rockfish",NA,2005,54,168,3,171,0,171,"nwfsc_wcgbt"
"redbanded rockfish",NA,2006,48,145,7,152,0,145,"nwfsc_wcgbt"
"redbanded rockfish",NA,2007,52,166,12,178,0,178,"nwfsc_wcgbt"
"redbanded rockfish",NA,2008,52,142,4,146,0,146,"nwfsc_wcgbt"
"redbanded rockfish",NA,2009,53,135,7,142,0,142,"nwfsc_wcgbt"
"redbanded rockfish",NA,2010,37,166,1,167,0,167,"nwfsc_wcgbt"
"redbanded rockfish",NA,2011,52,208,3,211,0,203,"nwfsc_wcgbt"
"redbanded rockfish",NA,2012,61,143,6,149,0,149,"nwfsc_wcgbt"
"redbanded rockfish",NA,2013,49,180,9,189,0,189,"nwfsc_wcgbt"
"redbanded rockfish",NA,2014,58,219,4,223,0,203,"nwfsc_wcgbt"
"redbanded rockfish",NA,2015,55,187,2,189,0,189,"nwfsc_wcgbt"
"redbanded rockfish",NA,2016,48,111,3,114,0,114,"nwfsc_wcgbt"
"redbanded rockfish",NA,2017,68,262,8,270,0,268,"nwfsc_wcgbt"
"redbanded rockfish",NA,2018,53,266,7,273,0,236,"nwfsc_wcgbt"
"redbanded rockfish",NA,2019,30,114,2,116,0,109,"nwfsc_wcgbt"
"redbanded rockfish",NA,2021,71,219,7,226,0,226,"nwfsc_wcgbt"
"redstripe rockfish",NA,2003,24,766,302,1068,0,246,"nwfsc_wcgbt"
"redstripe rockfish",NA,2004,15,521,6,527,0,179,"nwfsc_wcgbt"
"redstripe rockfish",NA,2005,17,238,2,240,0,113,"nwfsc_wcgbt"
"redstripe rockfish",NA,2006,16,507,0,507,0,131,"nwfsc_wcgbt"
"redstripe rockfish",NA,2007,9,352,4,356,0,102,"nwfsc_wcgbt"
"redstripe rockfish",NA,2008,13,326,7,333,0,131,"nwfsc_wcgbt"
"redstripe rockfish",NA,2009,14,394,13,407,0,265,"nwfsc_wcgbt"
"redstripe rockfish",NA,2010,11,61,0,61,0,61,"nwfsc_wcgbt"
"redstripe rockfish",NA,2011,14,597,0,597,0,295,"nwfsc_wcgbt"
"redstripe rockfish",NA,2012,9,224,0,224,0,113,"nwfsc_wcgbt"
"redstripe rockfish",NA,2013,10,408,0,408,0,210,"nwfsc_wcgbt"
"redstripe rockfish",NA,2014,14,505,0,505,0,314,"nwfsc_wcgbt"
"redstripe rockfish",NA,2015,15,242,63,305,0,147,"nwfsc_wcgbt"
"redstripe rockfish",NA,2016,17,569,78,647,0,324,"nwfsc_wcgbt"
"redstripe rockfish",NA,2017,16,317,0,317,0,201,"nwfsc_wcgbt"
"redstripe rockfish",NA,2018,10,259,0,259,0,190,"nwfsc_wcgbt"
"redstripe rockfish",NA,2019,5,168,0,168,0,123,"nwfsc_wcgbt"
"redstripe rockfish",NA,2021,7,219,0,219,0,157,"nwfsc_wcgbt"
"rex sole",NA,2003,171,10843,0,10843,0,0,"nwfsc_wcgbt"
"rex sole",NA,2004,305,13884,48,13932,0,0,"nwfsc_wcgbt"
"rex sole",NA,2005,425,15980,27,16007,0,0,"nwfsc_wcgbt"
"rex sole",NA,2006,396,11580,0,11580,0,0,"nwfsc_wcgbt"
"rex sole",NA,2007,423,9608,13,9621,0,801,"nwfsc_wcgbt"
"rex sole",NA,2008,399,7166,61,7227,0,763,"nwfsc_wcgbt"
"rex sole",NA,2009,395,4088,26,4114,0,780,"nwfsc_wcgbt"
"rex sole",NA,2010,442,2611,47,2658,0,885,"nwfsc_wcgbt"
"rex sole",NA,2011,424,6921,67,6988,0,838,"nwfsc_wcgbt"
"rex sole",NA,2012,432,7399,27,7426,0,850,"nwfsc_wcgbt"
"rex sole",NA,2013,305,5720,9,5729,0,600,"nwfsc_wcgbt"
"rex sole",NA,2014,432,8667,15,8682,0,852,"nwfsc_wcgbt"
"rex sole",NA,2015,418,8500,17,8517,0,818,"nwfsc_wcgbt"
"rex sole",NA,2016,426,8643,24,8667,0,841,"nwfsc_wcgbt"
"rex sole",NA,2017,427,5203,28,5231,0,829,"nwfsc_wcgbt"
"rex sole",NA,2018,431,4822,9,4831,0,850,"nwfsc_wcgbt"
"rex sole",NA,2019,210,2423,1,2424,0,415,"nwfsc_wcgbt"
"rex sole",NA,2021,420,4087,10,4097,0,821,"nwfsc_wcgbt"
"rosethorn rockfish",NA,2003,62,1592,10,1602,0,382,"nwfsc_wcgbt"
"rosethorn rockfish",NA,2004,40,990,13,1003,0,353,"nwfsc_wcgbt"
"rosethorn rockfish",NA,2005,43,923,5,928,0,322,"nwfsc_wcgbt"
"rosethorn rockfish",NA,2006,58,1577,1,1578,0,496,"nwfsc_wcgbt"
"rosethorn rockfish",NA,2007,53,1277,43,1320,0,507,"nwfsc_wcgbt"
"rosethorn rockfish",NA,2008,44,807,4,811,0,366,"nwfsc_wcgbt"
"rosethorn rockfish",NA,2009,57,1114,30,1144,0,481,"nwfsc_wcgbt"
"rosethorn rockfish",NA,2010,55,1204,36,1240,0,507,"nwfsc_wcgbt"
"rosethorn rockfish",NA,2011,61,1265,13,1278,0,527,"nwfsc_wcgbt"
"rosethorn rockfish",NA,2012,44,726,35,761,0,360,"nwfsc_wcgbt"
"rosethorn rockfish",NA,2013,39,793,16,809,0,345,"nwfsc_wcgbt"
"rosethorn rockfish",NA,2014,54,978,32,1010,0,508,"nwfsc_wcgbt"
"rosethorn rockfish",NA,2015,39,723,2,725,0,333,"nwfsc_wcgbt"
"rosethorn rockfish",NA,2016,65,1164,4,1168,0,538,"nwfsc_wcgbt"
"rosethorn rockfish",NA,2017,47,1206,24,1230,0,423,"nwfsc_wcgbt"
"rosethorn rockfish",NA,2018,48,663,12,675,0,410,"nwfsc_wcgbt"
"rosethorn rockfish",NA,2019,18,227,0,227,0,131,"nwfsc_wcgbt"
"rosethorn rockfish",NA,2021,53,730,19,749,0,428,"nwfsc_wcgbt"
"rosy rockfish",NA,2004,1,3,0,3,0,3,"nwfsc_wcgbt"
"rosy rockfish",NA,2005,5,8,3,11,0,11,"nwfsc_wcgbt"
"rosy rockfish",NA,2007,2,41,0,41,0,16,"nwfsc_wcgbt"
"rosy rockfish",NA,2008,7,199,23,222,0,70,"nwfsc_wcgbt"
"rosy rockfish",NA,2009,2,1,1,2,0,2,"nwfsc_wcgbt"
"rosy rockfish",NA,2010,2,5,0,5,0,5,"nwfsc_wcgbt"
"rosy rockfish",NA,2011,1,1,0,1,0,1,"nwfsc_wcgbt"
"rosy rockfish",NA,2013,1,3,0,3,0,0,"nwfsc_wcgbt"
"rosy rockfish",NA,2014,1,1,0,1,0,1,"nwfsc_wcgbt"
"rosy rockfish",NA,2016,3,9,0,9,0,9,"nwfsc_wcgbt"
"rosy rockfish",NA,2017,4,14,0,14,0,14,"nwfsc_wcgbt"
"rosy rockfish",NA,2018,2,4,0,4,0,4,"nwfsc_wcgbt"
"rosy rockfish",NA,2019,4,23,1,24,0,24,"nwfsc_wcgbt"
"rosy rockfish",NA,2021,1,2,0,2,0,2,"nwfsc_wcgbt"
"rougheye and blackspotted rockfish",NA,2003,34,112,0,112,56,0,"nwfsc_wcgbt"
"rougheye and blackspotted rockfish",NA,2004,27,113,2,115,78,0,"nwfsc_wcgbt"
"rougheye and blackspotted rockfish",NA,2005,27,259,0,259,139,1,"nwfsc_wcgbt"
"rougheye and blackspotted rockfish",NA,2006,36,101,1,102,94,6,"nwfsc_wcgbt"
"rougheye and blackspotted rockfish",NA,2007,37,107,1,108,107,0,"nwfsc_wcgbt"
"rougheye and blackspotted rockfish",NA,2008,36,120,2,122,121,1,"nwfsc_wcgbt"
"rougheye and blackspotted rockfish",NA,2009,27,126,0,126,91,5,"nwfsc_wcgbt"
"rougheye and blackspotted rockfish",NA,2010,29,89,0,89,88,1,"nwfsc_wcgbt"
"rougheye and blackspotted rockfish",NA,2011,30,115,0,115,109,6,"nwfsc_wcgbt"
"rougheye and blackspotted rockfish",NA,2012,25,85,2,87,79,6,"nwfsc_wcgbt"
"rougheye and blackspotted rockfish",NA,2013,21,67,1,68,0,68,"nwfsc_wcgbt"
"rougheye and blackspotted rockfish",NA,2014,22,40,2,42,0,23,"nwfsc_wcgbt"
"rougheye and blackspotted rockfish",NA,2015,37,182,3,185,0,174,"nwfsc_wcgbt"
"rougheye and blackspotted rockfish",NA,2016,32,103,2,105,0,105,"nwfsc_wcgbt"
"rougheye and blackspotted rockfish",NA,2017,28,165,3,168,0,124,"nwfsc_wcgbt"
"rougheye and blackspotted rockfish",NA,2018,25,97,0,97,0,97,"nwfsc_wcgbt"
"rougheye and blackspotted rockfish",NA,2019,10,57,1,58,0,58,"nwfsc_wcgbt"
"rougheye and blackspotted rockfish",NA,2021,30,139,10,149,0,149,"nwfsc_wcgbt"
"sablefish",NA,2003,420,5779,20,5799,1389,992,"nwfsc_wcgbt"
"sablefish",NA,2004,329,4536,4,4540,1086,1053,"nwfsc_wcgbt"
"sablefish",NA,2005,445,5543,24,5567,1575,1295,"nwfsc_wcgbt"
"sablefish",NA,2006,398,4831,2,4833,1363,1306,"nwfsc_wcgbt"
"sablefish",NA,2007,422,4460,10,4470,1259,857,"nwfsc_wcgbt"
"sablefish",NA,2008,420,3430,543,3973,1190,995,"nwfsc_wcgbt"
"sablefish",NA,2009,419,3659,29,3688,1181,669,"nwfsc_wcgbt"
"sablefish",NA,2010,458,3828,404,4232,1271,876,"nwfsc_wcgbt"
"sablefish",NA,2011,455,4624,50,4674,1193,600,"nwfsc_wcgbt"
"sablefish",NA,2012,428,4366,15,4381,1091,606,"nwfsc_wcgbt"
"sablefish",NA,2013,307,3146,134,3280,992,212,"nwfsc_wcgbt"
"sablefish",NA,2014,461,4312,7,4319,1200,600,"nwfsc_wcgbt"
"sablefish",NA,2015,420,4889,21,4910,1197,528,"nwfsc_wcgbt"
"sablefish",NA,2016,438,4425,119,4544,1213,256,"nwfsc_wcgbt"
"sablefish",NA,2017,459,4866,17,4883,1219,354,"nwfsc_wcgbt"
"sablefish",NA,2018,435,4780,5,4785,1482,11,"nwfsc_wcgbt"
"sablefish",NA,2019,226,2223,3,2226,874,10,"nwfsc_wcgbt"
"sablefish",NA,2021,518,5996,285,6281,0,2177,"nwfsc_wcgbt"
"sand sole",NA,2003,6,79,0,79,0,0,"nwfsc_wcgbt"
"sand sole",NA,2004,5,29,0,29,0,0,"nwfsc_wcgbt"
"sand sole",NA,2005,6,31,0,31,0,0,"nwfsc_wcgbt"
"sand sole",NA,2006,3,11,1,12,0,0,"nwfsc_wcgbt"
"sand sole",NA,2007,7,37,0,37,0,0,"nwfsc_wcgbt"
"sand sole",NA,2008,12,62,0,62,0,62,"nwfsc_wcgbt"
"sand sole",NA,2009,9,48,0,48,0,38,"nwfsc_wcgbt"
"sand sole",NA,2010,10,93,0,93,0,93,"nwfsc_wcgbt"
"sand sole",NA,2011,18,123,0,123,0,122,"nwfsc_wcgbt"
"sand sole",NA,2012,9,37,0,37,0,34,"nwfsc_wcgbt"
"sand sole",NA,2013,13,47,0,47,0,43,"nwfsc_wcgbt"
"sand sole",NA,2014,9,50,0,50,0,50,"nwfsc_wcgbt"
"sand sole",NA,2015,9,74,0,74,0,0,"nwfsc_wcgbt"
"sand sole",NA,2016,10,26,0,26,0,0,"nwfsc_wcgbt"
"sand sole",NA,2017,16,83,0,83,0,0,"nwfsc_wcgbt"
"sand sole",NA,2018,7,36,0,36,0,0,"nwfsc_wcgbt"
"sand sole",NA,2019,6,42,0,42,0,42,"nwfsc_wcgbt"
"sand sole",NA,2021,19,133,1,134,0,108,"nwfsc_wcgbt"
"sharpchin rockfish",NA,2003,51,2350,5,2355,0,553,"nwfsc_wcgbt"
"sharpchin rockfish",NA,2004,33,1173,3,1176,0,199,"nwfsc_wcgbt"
"sharpchin rockfish",NA,2005,35,864,7,871,0,153,"nwfsc_wcgbt"
"sharpchin rockfish",NA,2006,43,1283,0,1283,0,239,"nwfsc_wcgbt"
"sharpchin rockfish",NA,2007,35,975,0,975,0,204,"nwfsc_wcgbt"
"sharpchin rockfish",NA,2008,26,919,4,923,0,365,"nwfsc_wcgbt"
"sharpchin rockfish",NA,2009,39,934,4,938,0,593,"nwfsc_wcgbt"
"sharpchin rockfish",NA,2010,43,568,6,574,0,381,"nwfsc_wcgbt"
"sharpchin rockfish",NA,2011,48,1304,3,1307,0,781,"nwfsc_wcgbt"
"sharpchin rockfish",NA,2012,41,954,43,997,0,478,"nwfsc_wcgbt"
"sharpchin rockfish",NA,2013,38,874,0,874,0,375,"nwfsc_wcgbt"
"sharpchin rockfish",NA,2014,54,1357,64,1421,0,606,"nwfsc_wcgbt"
"sharpchin rockfish",NA,2015,53,1052,41,1093,0,620,"nwfsc_wcgbt"
"sharpchin rockfish",NA,2016,56,844,10,854,0,501,"nwfsc_wcgbt"
"sharpchin rockfish",NA,2017,52,830,16,846,0,535,"nwfsc_wcgbt"
"sharpchin rockfish",NA,2018,47,720,3,723,0,437,"nwfsc_wcgbt"
"sharpchin rockfish",NA,2019,33,443,0,443,0,289,"nwfsc_wcgbt"
"sharpchin rockfish",NA,2021,56,848,9,857,0,547,"nwfsc_wcgbt"
"shortraker rockfish",NA,2003,2,3,0,3,0,0,"nwfsc_wcgbt"
"shortraker rockfish",NA,2004,3,8,0,8,0,8,"nwfsc_wcgbt"
"shortraker rockfish",NA,2005,2,8,0,8,0,8,"nwfsc_wcgbt"
"shortraker rockfish",NA,2013,1,1,0,1,0,1,"nwfsc_wcgbt"
"shortraker rockfish",NA,2014,2,3,0,3,0,3,"nwfsc_wcgbt"
"shortraker rockfish",NA,2015,1,18,0,18,0,17,"nwfsc_wcgbt"
"shortraker rockfish",NA,2017,1,3,0,3,0,3,"nwfsc_wcgbt"
"shortraker rockfish",NA,2018,1,2,0,2,0,2,"nwfsc_wcgbt"
"shortspine thornyhead",NA,2003,293,59,7634,7693,0,1255,"nwfsc_wcgbt"
"shortspine thornyhead",NA,2004,214,2187,4507,6694,0,1671,"nwfsc_wcgbt"
"shortspine thornyhead",NA,2005,315,6736,1311,8047,0,1374,"nwfsc_wcgbt"
"shortspine thornyhead",NA,2006,332,5280,918,6198,0,1244,"nwfsc_wcgbt"
"shortspine thornyhead",NA,2007,367,4779,720,5499,0,1294,"nwfsc_wcgbt"
"shortspine thornyhead",NA,2008,362,4040,657,4697,0,1301,"nwfsc_wcgbt"
"shortspine thornyhead",NA,2009,340,3554,641,4195,0,1229,"nwfsc_wcgbt"
"shortspine thornyhead",NA,2010,360,3200,659,3859,0,1272,"nwfsc_wcgbt"
"shortspine thornyhead",NA,2011,347,3896,801,4697,0,1236,"nwfsc_wcgbt"
"shortspine thornyhead",NA,2012,349,3670,1008,4678,0,1243,"nwfsc_wcgbt"
"shortspine thornyhead",NA,2013,247,2455,634,3089,0,891,"nwfsc_wcgbt"
"shortspine thornyhead",NA,2014,346,3825,767,4592,0,1256,"nwfsc_wcgbt"
"shortspine thornyhead",NA,2015,332,3707,789,4496,0,1220,"nwfsc_wcgbt"
"shortspine thornyhead",NA,2016,355,3991,613,4604,0,1000,"nwfsc_wcgbt"
"shortspine thornyhead",NA,2017,363,4328,402,4730,0,1009,"nwfsc_wcgbt"
"shortspine thornyhead",NA,2018,368,4489,507,4996,0,733,"nwfsc_wcgbt"
"shortspine thornyhead",NA,2019,175,2263,138,2401,0,340,"nwfsc_wcgbt"
"shortspine thornyhead",NA,2021,345,4455,235,4690,0,682,"nwfsc_wcgbt"
"silvergray rockfish",NA,2003,9,34,0,34,0,34,"nwfsc_wcgbt"
"silvergray rockfish",NA,2004,3,19,0,19,0,19,"nwfsc_wcgbt"
"silvergray rockfish",NA,2005,6,51,0,51,0,46,"nwfsc_wcgbt"
"silvergray rockfish",NA,2006,3,7,0,7,0,7,"nwfsc_wcgbt"
"silvergray rockfish",NA,2007,8,22,0,22,0,22,"nwfsc_wcgbt"
"silvergray rockfish",NA,2008,6,20,0,20,0,20,"nwfsc_wcgbt"
"silvergray rockfish",NA,2009,5,36,0,36,0,36,"nwfsc_wcgbt"
"silvergray rockfish",NA,2010,8,47,0,47,0,47,"nwfsc_wcgbt"
"silvergray rockfish",NA,2011,14,116,0,116,0,81,"nwfsc_wcgbt"
"silvergray rockfish",NA,2012,8,46,0,46,0,46,"nwfsc_wcgbt"
"silvergray rockfish",NA,2013,6,44,0,44,0,26,"nwfsc_wcgbt"
"silvergray rockfish",NA,2014,5,16,0,16,0,16,"nwfsc_wcgbt"
"silvergray rockfish",NA,2015,4,80,0,80,0,23,"nwfsc_wcgbt"
"silvergray rockfish",NA,2016,3,5,0,5,0,5,"nwfsc_wcgbt"
"silvergray rockfish",NA,2017,8,75,0,75,0,75,"nwfsc_wcgbt"
"silvergray rockfish",NA,2018,8,30,0,30,0,30,"nwfsc_wcgbt"
"silvergray rockfish",NA,2019,7,105,0,105,0,105,"nwfsc_wcgbt"
"silvergray rockfish",NA,2021,5,5,0,5,0,5,"nwfsc_wcgbt"
"southern rock sole",NA,2004,23,161,0,161,0,0,"nwfsc_wcgbt"
"southern rock sole",NA,2005,29,154,0,154,0,0,"nwfsc_wcgbt"
"southern rock sole",NA,2006,25,168,0,168,0,0,"nwfsc_wcgbt"
"southern rock sole",NA,2007,37,174,0,174,0,0,"nwfsc_wcgbt"
"southern rock sole",NA,2008,29,247,0,247,0,0,"nwfsc_wcgbt"
"southern rock sole",NA,2009,33,194,1,195,0,0,"nwfsc_wcgbt"
"southern rock sole",NA,2010,32,159,4,163,0,0,"nwfsc_wcgbt"
"southern rock sole",NA,2011,35,259,0,259,0,0,"nwfsc_wcgbt"
"southern rock sole",NA,2012,44,255,0,255,0,0,"nwfsc_wcgbt"
"southern rock sole",NA,2013,36,227,0,227,0,0,"nwfsc_wcgbt"
"southern rock sole",NA,2014,50,370,1,371,0,0,"nwfsc_wcgbt"
"southern rock sole",NA,2015,39,361,0,361,0,340,"nwfsc_wcgbt"
"southern rock sole",NA,2016,38,173,0,173,0,158,"nwfsc_wcgbt"
"southern rock sole",NA,2017,44,389,2,391,0,0,"nwfsc_wcgbt"
"southern rock sole",NA,2018,37,242,0,242,0,0,"nwfsc_wcgbt"
"southern rock sole",NA,2019,20,127,0,127,0,90,"nwfsc_wcgbt"
"southern rock sole",NA,2021,44,301,4,305,0,224,"nwfsc_wcgbt"
"speckled rockfish",NA,2006,2,17,0,17,0,17,"nwfsc_wcgbt"
"speckled rockfish",NA,2007,3,106,0,106,0,25,"nwfsc_wcgbt"
"speckled rockfish",NA,2009,6,19,0,19,0,19,"nwfsc_wcgbt"
"speckled rockfish",NA,2010,3,4,3,7,0,7,"nwfsc_wcgbt"
"speckled rockfish",NA,2012,1,1,0,1,0,1,"nwfsc_wcgbt"
"speckled rockfish",NA,2013,5,70,0,70,0,23,"nwfsc_wcgbt"
"speckled rockfish",NA,2014,1,11,0,11,0,11,"nwfsc_wcgbt"
"speckled rockfish",NA,2016,1,11,0,11,0,11,"nwfsc_wcgbt"
"speckled rockfish",NA,2017,1,8,0,8,0,8,"nwfsc_wcgbt"
"speckled rockfish",NA,2018,1,1,0,1,0,1,"nwfsc_wcgbt"
"speckled rockfish",NA,2019,2,4,0,4,0,4,"nwfsc_wcgbt"
"splitnose rockfish",NA,2003,134,6216,417,6633,513,555,"nwfsc_wcgbt"
"splitnose rockfish",NA,2004,98,4821,314,5135,418,9,"nwfsc_wcgbt"
"splitnose rockfish",NA,2005,126,4052,415,4467,498,45,"nwfsc_wcgbt"
"splitnose rockfish",NA,2006,146,3181,380,3561,494,120,"nwfsc_wcgbt"
"splitnose rockfish",NA,2007,158,2775,588,3363,495,389,"nwfsc_wcgbt"
"splitnose rockfish",NA,2008,153,2539,379,2918,488,342,"nwfsc_wcgbt"
"splitnose rockfish",NA,2009,153,2447,520,2967,0,895,"nwfsc_wcgbt"
"splitnose rockfish",NA,2010,129,1525,496,2021,0,710,"nwfsc_wcgbt"
"splitnose rockfish",NA,2011,132,1678,473,2151,0,725,"nwfsc_wcgbt"
"splitnose rockfish",NA,2012,136,1658,257,1915,0,745,"nwfsc_wcgbt"
"splitnose rockfish",NA,2013,102,1185,222,1407,0,555,"nwfsc_wcgbt"
"splitnose rockfish",NA,2014,140,1614,345,1959,0,701,"nwfsc_wcgbt"
"splitnose rockfish",NA,2015,132,1616,265,1881,0,697,"nwfsc_wcgbt"
"splitnose rockfish",NA,2016,129,1758,165,1923,0,729,"nwfsc_wcgbt"
"splitnose rockfish",NA,2017,129,1587,304,1891,0,520,"nwfsc_wcgbt"
"splitnose rockfish",NA,2018,114,1579,212,1791,0,470,"nwfsc_wcgbt"
"splitnose rockfish",NA,2019,74,969,101,1070,0,294,"nwfsc_wcgbt"
"splitnose rockfish",NA,2021,130,1606,393,1999,0,555,"nwfsc_wcgbt"
"squarespot rockfish",NA,2003,2,30,0,30,0,0,"nwfsc_wcgbt"
"squarespot rockfish",NA,2004,5,141,18,159,0,25,"nwfsc_wcgbt"
"squarespot rockfish",NA,2005,13,219,26,245,41,26,"nwfsc_wcgbt"
"squarespot rockfish",NA,2006,6,151,1,152,10,39,"nwfsc_wcgbt"
"squarespot rockfish",NA,2007,13,333,91,424,33,60,"nwfsc_wcgbt"
"squarespot rockfish",NA,2008,10,234,5,239,36,44,"nwfsc_wcgbt"
"squarespot rockfish",NA,2009,16,487,3,490,34,74,"nwfsc_wcgbt"
"squarespot rockfish",NA,2010,13,181,4,185,17,46,"nwfsc_wcgbt"
"squarespot rockfish",NA,2011,6,64,13,77,11,24,"nwfsc_wcgbt"
"squarespot rockfish",NA,2012,6,28,4,32,5,27,"nwfsc_wcgbt"
"squarespot rockfish",NA,2013,10,517,7,524,21,73,"nwfsc_wcgbt"
"squarespot rockfish",NA,2014,9,17,215,232,6,40,"nwfsc_wcgbt"
"squarespot rockfish",NA,2015,9,223,24,247,34,52,"nwfsc_wcgbt"
"squarespot rockfish",NA,2016,18,172,157,329,59,79,"nwfsc_wcgbt"
"squarespot rockfish",NA,2017,11,277,45,322,62,66,"nwfsc_wcgbt"
"squarespot rockfish",NA,2018,11,193,47,240,17,91,"nwfsc_wcgbt"
"squarespot rockfish",NA,2019,6,187,19,206,22,43,"nwfsc_wcgbt"
"squarespot rockfish",NA,2021,10,183,1,184,0,111,"nwfsc_wcgbt"
"starry flounder",NA,2004,4,36,0,36,0,30,"nwfsc_wcgbt"
"starry flounder",NA,2005,7,41,1,42,0,31,"nwfsc_wcgbt"
"starry flounder",NA,2006,4,7,0,7,0,7,"nwfsc_wcgbt"
"starry flounder",NA,2007,6,15,0,15,0,15,"nwfsc_wcgbt"
"starry flounder",NA,2008,9,22,0,22,0,22,"nwfsc_wcgbt"
"starry flounder",NA,2009,11,21,0,21,0,21,"nwfsc_wcgbt"
"starry flounder",NA,2010,13,27,0,27,0,27,"nwfsc_wcgbt"
"starry flounder",NA,2011,18,62,0,62,0,62,"nwfsc_wcgbt"
"starry flounder",NA,2012,7,15,0,15,0,15,"nwfsc_wcgbt"
"starry flounder",NA,2013,10,26,0,26,0,0,"nwfsc_wcgbt"
"starry flounder",NA,2014,8,36,0,36,0,36,"nwfsc_wcgbt"
"starry flounder",NA,2015,10,42,0,42,0,33,"nwfsc_wcgbt"
"starry flounder",NA,2016,10,43,0,43,0,43,"nwfsc_wcgbt"
"starry flounder",NA,2017,16,29,0,29,0,29,"nwfsc_wcgbt"
"starry flounder",NA,2018,6,23,0,23,0,23,"nwfsc_wcgbt"
"starry flounder",NA,2019,6,13,0,13,0,13,"nwfsc_wcgbt"
"starry flounder",NA,2021,11,16,0,16,0,16,"nwfsc_wcgbt"
"starry rockfish",NA,2003,1,1,0,1,0,0,"nwfsc_wcgbt"
"starry rockfish",NA,2004,3,3,0,3,0,3,"nwfsc_wcgbt"
"starry rockfish",NA,2005,2,3,0,3,0,3,"nwfsc_wcgbt"
"starry rockfish",NA,2006,1,1,0,1,0,1,"nwfsc_wcgbt"
"starry rockfish",NA,2007,3,6,0,6,0,6,"nwfsc_wcgbt"
"starry rockfish",NA,2008,2,2,0,2,0,2,"nwfsc_wcgbt"
"starry rockfish",NA,2009,6,17,1,18,0,18,"nwfsc_wcgbt"
"starry rockfish",NA,2010,2,2,0,2,0,2,"nwfsc_wcgbt"
"starry rockfish",NA,2011,1,1,0,1,0,1,"nwfsc_wcgbt"
"starry rockfish",NA,2012,2,3,0,3,0,3,"nwfsc_wcgbt"
"starry rockfish",NA,2013,1,2,0,2,0,0,"nwfsc_wcgbt"
"starry rockfish",NA,2016,2,2,0,2,0,2,"nwfsc_wcgbt"
"starry rockfish",NA,2017,5,9,0,9,0,6,"nwfsc_wcgbt"
"starry rockfish",NA,2018,4,9,1,10,0,10,"nwfsc_wcgbt"
"starry rockfish",NA,2019,4,16,0,16,0,16,"nwfsc_wcgbt"
"stripetail rockfish",NA,2003,112,5303,610,5913,0,0,"nwfsc_wcgbt"
"stripetail rockfish",NA,2004,113,4267,390,4657,0,488,"nwfsc_wcgbt"
"stripetail rockfish",NA,2005,136,3903,399,4302,0,540,"nwfsc_wcgbt"
"stripetail rockfish",NA,2006,136,3204,66,3270,0,526,"nwfsc_wcgbt"
"stripetail rockfish",NA,2007,138,2182,52,2234,0,545,"nwfsc_wcgbt"
"stripetail rockfish",NA,2008,120,1655,154,1809,0,434,"nwfsc_wcgbt"
"stripetail rockfish",NA,2009,148,1886,171,2057,0,731,"nwfsc_wcgbt"
"stripetail rockfish",NA,2010,166,1668,437,2105,0,894,"nwfsc_wcgbt"
"stripetail rockfish",NA,2011,156,1826,790,2616,0,834,"nwfsc_wcgbt"
"stripetail rockfish",NA,2012,149,1685,454,2139,0,603,"nwfsc_wcgbt"
"stripetail rockfish",NA,2013,93,1139,61,1200,0,375,"nwfsc_wcgbt"
"stripetail rockfish",NA,2014,146,1696,496,2192,0,601,"nwfsc_wcgbt"
"stripetail rockfish",NA,2015,163,1823,294,2117,0,641,"nwfsc_wcgbt"
"stripetail rockfish",NA,2016,147,1804,261,2065,0,589,"nwfsc_wcgbt"
"stripetail rockfish",NA,2017,178,1966,457,2423,0,695,"nwfsc_wcgbt"
"stripetail rockfish",NA,2018,163,1984,219,2203,0,656,"nwfsc_wcgbt"
"stripetail rockfish",NA,2019,82,1286,78,1364,0,349,"nwfsc_wcgbt"
"stripetail rockfish",NA,2021,164,1920,594,2514,0,718,"nwfsc_wcgbt"
"tree rockfish",NA,2005,1,1,0,1,0,1,"nwfsc_wcgbt"
"vermilion and sunset rockfish",NA,2003,6,61,1,62,0,0,"nwfsc_wcgbt"
"vermilion and sunset rockfish",NA,2004,3,8,1,9,8,0,"nwfsc_wcgbt"
"vermilion and sunset rockfish",NA,2005,6,48,1,49,11,17,"nwfsc_wcgbt"
"vermilion and sunset rockfish",NA,2006,5,27,0,27,18,9,"nwfsc_wcgbt"
"vermilion and sunset rockfish",NA,2007,8,120,0,120,56,0,"nwfsc_wcgbt"
"vermilion and sunset rockfish",NA,2008,12,73,1,74,39,26,"nwfsc_wcgbt"
"vermilion and sunset rockfish",NA,2009,13,223,0,223,114,15,"nwfsc_wcgbt"
"vermilion and sunset rockfish",NA,2010,15,78,28,106,93,13,"nwfsc_wcgbt"
"vermilion and sunset rockfish",NA,2011,4,28,0,28,4,24,"nwfsc_wcgbt"
"vermilion and sunset rockfish",NA,2012,15,467,4,471,106,204,"nwfsc_wcgbt"
"vermilion and sunset rockfish",NA,2013,11,396,9,405,70,165,"nwfsc_wcgbt"
"vermilion and sunset rockfish",NA,2014,14,35,2,37,26,11,"nwfsc_wcgbt"
"vermilion and sunset rockfish",NA,2015,12,226,0,226,9,138,"nwfsc_wcgbt"
"vermilion and sunset rockfish",NA,2016,20,75,25,100,56,44,"nwfsc_wcgbt"
"vermilion and sunset rockfish",NA,2017,16,199,44,243,75,132,"nwfsc_wcgbt"
"vermilion and sunset rockfish",NA,2018,12,196,1,197,47,93,"nwfsc_wcgbt"
"vermilion and sunset rockfish",NA,2019,7,172,0,172,44,89,"nwfsc_wcgbt"
"vermilion and sunset rockfish",NA,2021,20,91,192,283,0,204,"nwfsc_wcgbt"
"widow rockfish",NA,2003,18,212,4,216,0,10,"nwfsc_wcgbt"
"widow rockfish",NA,2004,12,84,0,84,43,0,"nwfsc_wcgbt"
"widow rockfish",NA,2005,20,78,0,78,65,2,"nwfsc_wcgbt"
"widow rockfish",NA,2006,26,172,0,172,89,0,"nwfsc_wcgbt"
"widow rockfish",NA,2007,27,91,1,92,83,0,"nwfsc_wcgbt"
"widow rockfish",NA,2008,17,26,0,26,20,6,"nwfsc_wcgbt"
"widow rockfish",NA,2009,32,142,0,142,124,0,"nwfsc_wcgbt"
"widow rockfish",NA,2010,28,240,0,240,116,2,"nwfsc_wcgbt"
"widow rockfish",NA,2011,31,313,0,313,152,0,"nwfsc_wcgbt"
"widow rockfish",NA,2012,32,181,0,181,91,2,"nwfsc_wcgbt"
"widow rockfish",NA,2013,18,361,3,364,246,0,"nwfsc_wcgbt"
"widow rockfish",NA,2014,28,349,0,349,264,0,"nwfsc_wcgbt"
"widow rockfish",NA,2015,21,149,0,149,93,0,"nwfsc_wcgbt"
"widow rockfish",NA,2016,40,888,0,888,556,0,"nwfsc_wcgbt"
"widow rockfish",NA,2017,30,310,0,310,213,1,"nwfsc_wcgbt"
"widow rockfish",NA,2018,34,410,0,410,353,0,"nwfsc_wcgbt"
"widow rockfish",NA,2019,23,219,0,219,0,161,"nwfsc_wcgbt"
"widow rockfish",NA,2021,16,55,1,56,0,56,"nwfsc_wcgbt"
"yelloweye rockfish",NA,2003,19,68,0,68,67,1,"nwfsc_wcgbt"
"yelloweye rockfish",NA,2004,8,21,0,21,21,0,"nwfsc_wcgbt"
"yelloweye rockfish",NA,2005,13,40,0,40,40,0,"nwfsc_wcgbt"
"yelloweye rockfish",NA,2006,13,42,1,43,43,0,"nwfsc_wcgbt"
"yelloweye rockfish",NA,2007,12,24,2,26,19,7,"nwfsc_wcgbt"
"yelloweye rockfish",NA,2008,15,43,0,43,43,0,"nwfsc_wcgbt"
"yelloweye rockfish",NA,2009,11,39,0,39,39,0,"nwfsc_wcgbt"
"yelloweye rockfish",NA,2010,15,52,0,52,52,0,"nwfsc_wcgbt"
"yelloweye rockfish",NA,2011,13,47,0,47,47,0,"nwfsc_wcgbt"
"yelloweye rockfish",NA,2012,14,44,0,44,44,0,"nwfsc_wcgbt"
"yelloweye rockfish",NA,2013,14,38,0,38,35,2,"nwfsc_wcgbt"
"yelloweye rockfish",NA,2014,19,92,0,92,92,0,"nwfsc_wcgbt"
"yelloweye rockfish",NA,2015,13,51,0,51,51,0,"nwfsc_wcgbt"
"yelloweye rockfish",NA,2016,25,91,0,91,91,0,"nwfsc_wcgbt"
"yelloweye rockfish",NA,2017,19,45,0,45,0,45,"nwfsc_wcgbt"
"yelloweye rockfish",NA,2018,24,50,0,50,0,50,"nwfsc_wcgbt"
"yelloweye rockfish",NA,2019,9,34,0,34,0,34,"nwfsc_wcgbt"
"yelloweye rockfish",NA,2021,19,55,0,55,0,55,"nwfsc_wcgbt"
"yellowmouth rockfish",NA,2003,5,141,0,141,0,34,"nwfsc_wcgbt"
"yellowmouth rockfish",NA,2005,2,23,0,23,0,23,"nwfsc_wcgbt"
"yellowmouth rockfish",NA,2010,1,1,0,1,0,1,"nwfsc_wcgbt"
"yellowmouth rockfish",NA,2011,5,54,0,54,0,54,"nwfsc_wcgbt"
"yellowmouth rockfish",NA,2012,3,3,0,3,0,3,"nwfsc_wcgbt"
"yellowmouth rockfish",NA,2013,4,10,0,10,0,10,"nwfsc_wcgbt"
"yellowmouth rockfish",NA,2014,1,1,0,1,0,1,"nwfsc_wcgbt"
"yellowmouth rockfish",NA,2015,2,13,0,13,0,13,"nwfsc_wcgbt"
"yellowmouth rockfish",NA,2016,6,85,0,85,0,57,"nwfsc_wcgbt"
"yellowmouth rockfish",NA,2017,5,29,0,29,0,29,"nwfsc_wcgbt"
"yellowmouth rockfish",NA,2018,4,149,0,149,0,54,"nwfsc_wcgbt"
"yellowtail rockfish",NA,2003,35,815,34,849,275,0,"nwfsc_wcgbt"
"yellowtail rockfish",NA,2004,26,626,0,626,187,1,"nwfsc_wcgbt"
"yellowtail rockfish",NA,2005,45,1047,0,1047,348,2,"nwfsc_wcgbt"
"yellowtail rockfish",NA,2006,35,386,0,386,169,0,"nwfsc_wcgbt"
"yellowtail rockfish",NA,2007,45,946,12,958,277,2,"nwfsc_wcgbt"
"yellowtail rockfish",NA,2008,37,682,8,690,355,0,"nwfsc_wcgbt"
"yellowtail rockfish",NA,2009,40,457,0,457,333,0,"nwfsc_wcgbt"
"yellowtail rockfish",NA,2010,46,1130,1,1131,486,432,"nwfsc_wcgbt"
"yellowtail rockfish",NA,2011,48,788,0,788,469,0,"nwfsc_wcgbt"
"yellowtail rockfish",NA,2012,46,906,1,907,354,0,"nwfsc_wcgbt"
"yellowtail rockfish",NA,2013,30,407,0,407,177,0,"nwfsc_wcgbt"
"yellowtail rockfish",NA,2014,55,1527,1,1528,651,1,"nwfsc_wcgbt"
"yellowtail rockfish",NA,2015,59,820,0,820,541,1,"nwfsc_wcgbt"
"yellowtail rockfish",NA,2016,80,2261,0,2261,571,837,"nwfsc_wcgbt"
"yellowtail rockfish",NA,2017,71,1701,0,1701,0,724,"nwfsc_wcgbt"
"yellowtail rockfish",NA,2018,61,916,0,916,0,628,"nwfsc_wcgbt"
"yellowtail rockfish",NA,2019,32,568,0,568,0,345,"nwfsc_wcgbt"
"yellowtail rockfish",NA,2021,35,493,0,493,0,383,"nwfsc_wcgbt"
