"species_name","sample_year","sexed_fish","unsexed_fish","lengthed","aged","otoliths"
"ARROWTOOTH FLOUNDER",2001,0,3,3,0,0
"ARROWTOOTH FLOUNDER",2002,0,7,7,0,0
"ARROWTOOTH FLOUNDER",2003,0,14,14,0,0
"ARROWTOOTH FLOUNDER",2004,0,14,14,0,0
"ARROWTOOTH FLOUNDER",2005,0,3,3,0,0
"ARROWTOOTH FLOUNDER",2006,0,13,13,0,0
"ARROWTOOTH FLOUNDER",2007,0,10,10,0,0
"ARROWTOOTH FLOUNDER",2008,0,8,8,0,0
"ARROWTOOTH FLOUNDER",2009,0,5,5,0,0
"ARROWTOOTH FLOUNDER",2010,0,1,1,0,0
"ARROWTOOTH FLOUNDER",2011,0,2,2,0,0
"ARROWTOOTH FLOUNDER",2012,0,1,1,0,0
"ARROWTOOTH FLOUNDER",2013,0,5,5,0,0
"ARROWTOOTH FLOUNDER",2014,0,4,4,0,0
"ARROWTOOTH FLOUNDER",2015,0,2,2,0,0
"ARROWTOOTH FLOUNDER",2016,0,8,8,0,0
"ARROWTOOTH FLOUNDER",2017,0,8,8,0,0
"ARROWTOOTH FLOUNDER",2018,0,6,6,0,0
"ARROWTOOTH FLOUNDER",2019,0,8,8,0,0
"BIG SKATE",2004,0,3,3,0,0
"BIG SKATE",2005,0,2,2,0,0
"BIG SKATE",2009,0,2,2,0,0
"BIG SKATE",2011,0,1,1,0,0
"BIG SKATE",2013,0,1,1,0,0
"BIG SKATE",2014,0,2,2,0,0
"BIG SKATE",2017,0,1,1,0,0
"BIG SKATE",2019,0,1,1,0,0
"BLACK ROCKFISH",1999,3608,158,3766,0,0
"BLACK ROCKFISH",2000,4833,23,4856,0,0
"BLACK ROCKFISH",2001,3101,5671,8772,3086,71
"BLACK ROCKFISH",2002,3757,3712,7469,3463,294
"BLACK ROCKFISH",2003,3461,3637,7098,2230,1214
"BLACK ROCKFISH",2004,3261,2754,6015,2287,1020
"BLACK ROCKFISH",2005,3125,3954,7079,1787,1331
"BLACK ROCKFISH",2006,2173,7295,9468,2247,0
"BLACK ROCKFISH",2007,2052,10741,12793,1988,40
"BLACK ROCKFISH",2008,1,11764,11765,0,0
"BLACK ROCKFISH",2009,1093,11344,12437,969,113
"BLACK ROCKFISH",2010,1161,11901,13062,1177,0
"BLACK ROCKFISH",2011,1107,11750,12857,861,263
"BLACK ROCKFISH",2012,1067,12394,13461,543,544
"BLACK ROCKFISH",2013,1038,12652,13690,526,520
"BLACK ROCKFISH",2014,1083,11708,12791,549,543
"BLACK ROCKFISH",2015,1078,12784,13862,1074,0
"BLACK ROCKFISH",2016,1098,10596,11694,530,554
"BLACK ROCKFISH",2017,991,10233,11224,494,485
"BLACK ROCKFISH",2018,1203,11825,13028,0,1203
"BLACK ROCKFISH",2019,1154,11727,12881,0,1159
"BLACK ROCKFISH",2020,1110,989,2099,0,1118
"BLUE ROCKFISH",2008,66,0,66,65,0
"BLUE ROCKFISH",2009,78,0,78,77,0
"BLUE ROCKFISH",2010,64,1,65,65,0
"BLUE ROCKFISH",2011,58,4,62,62,0
"BLUE ROCKFISH",2012,116,5,121,119,0
"BLUE ROCKFISH",2013,88,3,91,91,0
"BLUE ROCKFISH",2014,132,0,132,132,0
"BLUE ROCKFISH",2015,124,2,126,125,0
"BLUE ROCKFISH",2016,98,1136,1234,0,98
"BLUE ROCKFISH",2017,53,816,869,0,53
"BLUE ROCKFISH",2018,77,607,684,0,77
"BLUE ROCKFISH",2019,146,969,1115,0,149
"BLUE ROCKFISH",2020,67,86,153,0,70
"DEACON/BLUE ROCKFISH UNKNOWN",1999,711,15,726,0,0
"DEACON/BLUE ROCKFISH UNKNOWN",2000,566,0,566,0,0
"DEACON/BLUE ROCKFISH UNKNOWN",2001,1359,2849,4208,0,1393
"DEACON/BLUE ROCKFISH UNKNOWN",2002,737,1944,2681,0,739
"DEACON/BLUE ROCKFISH UNKNOWN",2003,784,2547,3331,0,785
"DEACON/BLUE ROCKFISH UNKNOWN",2004,501,1769,2270,146,352
"DEACON/BLUE ROCKFISH UNKNOWN",2005,478,3061,3539,0,477
"DEACON/BLUE ROCKFISH UNKNOWN",2006,898,3475,4373,0,899
"DEACON/BLUE ROCKFISH UNKNOWN",2007,863,4170,5033,0,863
"DEACON/BLUE ROCKFISH UNKNOWN",2008,34,4804,4838,0,34
"DEACON/BLUE ROCKFISH UNKNOWN",2009,30,4351,4381,0,29
"DEACON/BLUE ROCKFISH UNKNOWN",2010,43,5302,5345,0,47
"DEACON/BLUE ROCKFISH UNKNOWN",2011,6,4498,4504,0,7
"DEACON/BLUE ROCKFISH UNKNOWN",2012,9,4980,4989,0,10
"DEACON/BLUE ROCKFISH UNKNOWN",2013,3,3973,3976,0,3
"DEACON/BLUE ROCKFISH UNKNOWN",2014,2,3266,3268,0,2
"DEACON/BLUE ROCKFISH UNKNOWN",2015,0,4057,4057,0,0
"DEACON/BLUE ROCKFISH UNKNOWN",2016,0,168,168,0,0
"BOCACCIO",2001,0,47,47,0,0
"BOCACCIO",2002,0,157,157,0,0
"BOCACCIO",2003,0,64,64,0,0
"BOCACCIO",2004,0,20,20,0,0
"BOCACCIO",2005,0,14,14,0,0
"BOCACCIO",2006,0,11,11,0,0
"BOCACCIO",2007,0,16,16,0,0
"BOCACCIO",2008,0,7,7,0,0
"BOCACCIO",2009,0,11,11,0,0
"BOCACCIO",2011,0,8,8,0,0
"BOCACCIO",2012,0,14,14,0,0
"BOCACCIO",2013,0,7,7,0,0
"BOCACCIO",2014,0,8,8,0,0
"BOCACCIO",2015,0,1,1,0,0
"BOCACCIO",2016,0,2,2,0,0
"BOCACCIO",2017,0,5,5,0,0
"BOCACCIO",2018,0,130,130,0,0
"BOCACCIO",2019,0,75,75,0,0
"BOCACCIO",2020,0,2,2,0,0
"BROWN ROCKFISH",2001,0,11,11,0,0
"BROWN ROCKFISH",2002,0,7,7,0,0
"BROWN ROCKFISH",2003,0,10,10,0,0
"BROWN ROCKFISH",2004,0,2,2,0,0
"BROWN ROCKFISH",2005,2,11,13,2,0
"BROWN ROCKFISH",2006,0,21,21,0,0
"BROWN ROCKFISH",2007,0,9,9,0,0
"BROWN ROCKFISH",2008,4,18,22,4,0
"BROWN ROCKFISH",2009,1,20,21,1,0
"BROWN ROCKFISH",2010,1,44,45,1,0
"BROWN ROCKFISH",2011,1,34,35,1,0
"BROWN ROCKFISH",2012,1,5,6,1,0
"BROWN ROCKFISH",2013,3,9,12,3,0
"BROWN ROCKFISH",2014,0,7,7,0,0
"BROWN ROCKFISH",2015,0,10,10,0,0
"BROWN ROCKFISH",2016,0,7,7,0,0
"BROWN ROCKFISH",2017,1,13,14,0,1
"BROWN ROCKFISH",2018,0,11,11,0,0
"BROWN ROCKFISH",2019,3,35,38,0,3
"BROWN ROCKFISH",2020,21,6,27,0,21
"CABEZON",2001,0,520,520,0,0
"CABEZON",2002,0,1260,1260,0,0
"CABEZON",2003,0,1199,1199,0,0
"CABEZON",2004,0,1019,1019,0,0
"CABEZON",2005,73,1480,1553,68,0
"CABEZON",2006,337,1598,1935,313,1
"CABEZON",2007,229,1512,1741,177,0
"CABEZON",2008,383,1902,2285,327,0
"CABEZON",2009,431,1967,2398,423,0
"CABEZON",2010,349,1672,2021,6,345
"CABEZON",2011,332,1403,1735,329,0
"CABEZON",2012,278,1280,1558,5,273
"CABEZON",2013,152,916,1068,148,0
"CABEZON",2014,73,640,713,71,0
"CABEZON",2015,92,691,783,92,0
"CABEZON",2016,119,880,999,118,0
"CABEZON",2017,137,1165,1302,136,0
"CABEZON",2018,117,894,1011,115,0
"CABEZON",2019,115,866,981,0,115
"CABEZON",2020,78,4,82,0,78
"CANARY ROCKFISH",1999,393,0,393,0,0
"CANARY ROCKFISH",2000,367,0,367,0,0
"CANARY ROCKFISH",2001,18,1005,1023,0,18
"CANARY ROCKFISH",2002,0,1540,1540,0,0
"CANARY ROCKFISH",2003,0,1885,1885,0,0
"CANARY ROCKFISH",2004,0,139,139,0,0
"CANARY ROCKFISH",2005,0,207,207,0,0
"CANARY ROCKFISH",2006,1,216,217,0,0
"CANARY ROCKFISH",2007,1,138,139,0,0
"CANARY ROCKFISH",2008,0,206,206,0,0
"CANARY ROCKFISH",2009,1,218,219,0,0
"CANARY ROCKFISH",2010,0,194,194,0,0
"CANARY ROCKFISH",2011,0,137,137,0,0
"CANARY ROCKFISH",2012,1,213,214,0,0
"CANARY ROCKFISH",2013,0,202,202,0,0
"CANARY ROCKFISH",2014,0,244,244,0,0
"CANARY ROCKFISH",2015,615,2291,2906,0,618
"CANARY ROCKFISH",2016,500,1875,2375,0,506
"CANARY ROCKFISH",2017,699,3423,4122,0,703
"CANARY ROCKFISH",2018,559,4114,4673,0,559
"CANARY ROCKFISH",2019,584,3958,4542,0,592
"CANARY ROCKFISH",2020,575,359,934,0,587
"CHILIPEPPER",2001,0,8,8,0,0
"CHILIPEPPER",2002,0,3,3,0,0
"CHILIPEPPER",2003,0,2,2,0,0
"CHILIPEPPER",2004,0,1,1,0,0
"CHILIPEPPER",2007,0,2,2,0,0
"CHILIPEPPER",2008,0,2,2,0,0
"CHILIPEPPER",2009,0,2,2,0,0
"CHILIPEPPER",2012,0,1,1,0,0
"CHILIPEPPER",2013,0,3,3,0,0
"CHILIPEPPER",2018,0,6,6,0,0
"CHINA ROCKFISH",2001,0,373,373,0,0
"CHINA ROCKFISH",2002,0,644,644,0,0
"CHINA ROCKFISH",2003,0,685,685,0,0
"CHINA ROCKFISH",2004,0,398,398,0,0
"CHINA ROCKFISH",2005,56,621,677,110,0
"CHINA ROCKFISH",2006,190,719,909,248,0
"CHINA ROCKFISH",2007,264,901,1165,60,204
"CHINA ROCKFISH",2008,266,913,1179,60,209
"CHINA ROCKFISH",2009,180,658,838,62,121
"CHINA ROCKFISH",2010,173,744,917,60,115
"CHINA ROCKFISH",2011,232,892,1124,236,1
"CHINA ROCKFISH",2012,208,848,1056,60,148
"CHINA ROCKFISH",2013,147,792,939,146,1
"CHINA ROCKFISH",2014,73,322,395,0,73
"CHINA ROCKFISH",2015,0,28,28,0,0
"CHINA ROCKFISH",2016,0,13,13,0,0
"CHINA ROCKFISH",2017,67,320,387,0,68
"CHINA ROCKFISH",2018,107,476,583,0,108
"CHINA ROCKFISH",2019,131,454,585,0,132
"CHINA ROCKFISH",2020,46,39,85,0,46
"COPPER ROCKFISH",2001,0,196,196,0,0
"COPPER ROCKFISH",2002,0,641,641,0,0
"COPPER ROCKFISH",2003,0,518,518,0,0
"COPPER ROCKFISH",2004,0,325,325,0,0
"COPPER ROCKFISH",2005,59,696,755,58,0
"COPPER ROCKFISH",2006,149,764,913,150,0
"COPPER ROCKFISH",2007,189,799,988,188,0
"COPPER ROCKFISH",2008,217,836,1053,217,0
"COPPER ROCKFISH",2009,156,569,725,156,0
"COPPER ROCKFISH",2010,274,790,1064,273,0
"COPPER ROCKFISH",2011,233,867,1100,235,0
"COPPER ROCKFISH",2012,216,944,1160,216,0
"COPPER ROCKFISH",2013,158,570,728,158,0
"COPPER ROCKFISH",2014,121,338,459,121,0
"COPPER ROCKFISH",2015,0,32,32,0,0
"COPPER ROCKFISH",2016,0,28,28,0,0
"COPPER ROCKFISH",2017,176,566,742,177,0
"COPPER ROCKFISH",2018,175,983,1158,175,0
"COPPER ROCKFISH",2019,173,792,965,174,0
"COPPER ROCKFISH",2020,89,34,123,0,89
"CURLFIN SOLE",2004,0,1,1,0,0
"DARKBLOTCHED ROCKFISH",2002,0,1,1,0,0
"DARKBLOTCHED ROCKFISH",2017,0,1,1,0,0
"DOVER SOLE",2003,0,3,3,0,0
"DOVER SOLE",2005,0,4,4,0,0
"DOVER SOLE",2007,0,1,1,0,0
"DOVER SOLE",2010,0,4,4,0,0
"DOVER SOLE",2011,0,6,6,0,0
"DOVER SOLE",2012,0,1,1,0,0
"DOVER SOLE",2013,0,1,1,0,0
"DOVER SOLE",2015,0,1,1,0,0
"ENGLISH SOLE",2002,0,1,1,0,0
"ENGLISH SOLE",2003,0,3,3,0,0
"ENGLISH SOLE",2005,0,2,2,0,0
"ENGLISH SOLE",2006,0,4,4,0,0
"ENGLISH SOLE",2011,0,3,3,0,0
"ENGLISH SOLE",2012,0,2,2,0,0
"ENGLISH SOLE",2014,0,3,3,0,0
"ENGLISH SOLE",2018,0,2,2,0,0
"ENGLISH SOLE",2019,0,2,2,0,0
"FLAG ROCKFISH",2005,0,1,1,0,0
"FLAG ROCKFISH",2010,0,3,3,0,0
"FLAG ROCKFISH",2013,0,1,1,0,0
"FLAG ROCKFISH",2019,0,3,3,0,0
"FLATHEAD SOLE",2011,0,1,1,0,0
"GOPHER ROCKFISH",2002,0,1,1,0,0
"GOPHER ROCKFISH",2003,0,13,13,0,0
"GOPHER ROCKFISH",2004,0,3,3,0,0
"GOPHER ROCKFISH",2005,0,6,6,0,0
"GOPHER ROCKFISH",2006,0,4,4,0,0
"GOPHER ROCKFISH",2007,0,3,3,0,0
"GOPHER ROCKFISH",2008,2,1,3,0,2
"GOPHER ROCKFISH",2009,0,6,6,0,0
"GOPHER ROCKFISH",2010,1,4,5,0,1
"GOPHER ROCKFISH",2011,1,6,7,0,1
"GOPHER ROCKFISH",2012,0,4,4,0,0
"GOPHER ROCKFISH",2013,1,16,17,0,1
"GOPHER ROCKFISH",2014,2,4,6,0,2
"GOPHER ROCKFISH",2016,0,1,1,0,0
"GOPHER ROCKFISH",2017,0,1,1,0,0
"GOPHER ROCKFISH",2018,2,6,8,0,2
"GOPHER ROCKFISH",2019,0,8,8,0,0
"GOPHER ROCKFISH",2020,0,2,2,0,0
"GRASS ROCKFISH",2001,0,6,6,0,0
"GRASS ROCKFISH",2002,0,2,2,0,0
"GRASS ROCKFISH",2003,0,5,5,0,0
"GRASS ROCKFISH",2004,0,3,3,0,0
"GRASS ROCKFISH",2005,1,10,11,0,1
"GRASS ROCKFISH",2006,0,3,3,0,0
"GRASS ROCKFISH",2007,0,2,2,0,0
"GRASS ROCKFISH",2008,1,3,4,0,1
"GRASS ROCKFISH",2009,0,9,9,0,0
"GRASS ROCKFISH",2010,0,13,13,0,0
"GRASS ROCKFISH",2011,0,7,7,0,0
"GRASS ROCKFISH",2012,0,4,4,0,0
"GRASS ROCKFISH",2013,2,3,5,0,2
"GRASS ROCKFISH",2014,3,6,9,0,3
"GRASS ROCKFISH",2015,0,1,1,0,0
"GRASS ROCKFISH",2016,0,5,5,0,0
"GRASS ROCKFISH",2017,0,7,7,0,0
"GRASS ROCKFISH",2018,0,6,6,0,0
"GRASS ROCKFISH",2019,0,22,22,0,0
"GRASS ROCKFISH",2020,0,2,2,0,0
"GREENSPOTTED ROCKFISH",2004,0,10,10,0,0
"GREENSPOTTED ROCKFISH",2019,0,10,10,0,0
"GREENSTRIPED ROCKFISH",2001,0,79,79,0,0
"GREENSTRIPED ROCKFISH",2002,0,109,109,0,0
"GREENSTRIPED ROCKFISH",2003,0,141,141,0,0
"GREENSTRIPED ROCKFISH",2004,0,45,45,0,0
"GREENSTRIPED ROCKFISH",2005,0,24,24,0,0
"GREENSTRIPED ROCKFISH",2006,0,22,22,0,0
"GREENSTRIPED ROCKFISH",2007,0,2,2,0,0
"GREENSTRIPED ROCKFISH",2008,0,3,3,0,0
"GREENSTRIPED ROCKFISH",2009,0,3,3,0,0
"GREENSTRIPED ROCKFISH",2011,0,8,8,0,0
"GREENSTRIPED ROCKFISH",2012,0,3,3,0,0
"GREENSTRIPED ROCKFISH",2013,0,10,10,0,0
"GREENSTRIPED ROCKFISH",2015,0,1,1,0,0
"GREENSTRIPED ROCKFISH",2016,0,3,3,0,0
"GREENSTRIPED ROCKFISH",2017,0,12,12,0,0
"GREENSTRIPED ROCKFISH",2018,0,14,14,0,0
"GREENSTRIPED ROCKFISH",2019,0,40,40,0,0
"GREENSTRIPED ROCKFISH",2020,0,3,3,0,0
"KELP GREENLING",2001,0,515,515,0,0
"KELP GREENLING",2002,0,1280,1280,0,0
"KELP GREENLING",2003,2,1369,1371,0,0
"KELP GREENLING",2004,2,1092,1094,0,0
"KELP GREENLING",2005,153,1560,1713,294,0
"KELP GREENLING",2006,381,1355,1736,467,0
"KELP GREENLING",2007,338,1314,1652,334,0
"KELP GREENLING",2008,480,1835,2315,470,0
"KELP GREENLING",2009,520,1825,2345,257,259
"KELP GREENLING",2010,559,2583,3142,271,273
"KELP GREENLING",2011,703,2499,3202,289,405
"KELP GREENLING",2012,663,2431,3094,220,441
"KELP GREENLING",2013,560,2308,2868,184,367
"KELP GREENLING",2014,270,1050,1320,0,269
"KELP GREENLING",2015,171,961,1132,0,170
"KELP GREENLING",2016,164,783,947,0,164
"KELP GREENLING",2017,125,708,833,0,123
"KELP GREENLING",2018,131,865,996,0,122
"KELP GREENLING",2019,187,848,1035,0,183
"KELP GREENLING",2020,153,66,219,0,153
"LINGCOD",1999,1649,73,1722,0,0
"LINGCOD",2000,2246,15,2261,0,0
"LINGCOD",2001,1948,1465,3413,791,1163
"LINGCOD",2002,860,2933,3793,858,3
"LINGCOD",2003,891,3886,4777,807,12
"LINGCOD",2004,942,2238,3180,653,45
"LINGCOD",2005,775,3285,4060,541,22
"LINGCOD",2006,1392,4812,6204,799,371
"LINGCOD",2007,1149,5477,6626,788,250
"LINGCOD",2008,1180,5641,6821,740,294
"LINGCOD",2009,1138,4970,6108,258,771
"LINGCOD",2010,1153,5879,7032,260,759
"LINGCOD",2011,1217,6641,7858,258,799
"LINGCOD",2012,1216,8139,9355,260,786
"LINGCOD",2013,1157,8136,9293,258,774
"LINGCOD",2014,1090,6456,7546,259,754
"LINGCOD",2015,1129,7064,8193,259,769
"LINGCOD",2016,1087,5430,6517,260,730
"LINGCOD",2017,1010,5632,6642,260,691
"LINGCOD",2018,1162,7530,8692,258,814
"LINGCOD",2019,1081,6645,7726,258,737
"LINGCOD",2020,858,726,1584,0,856
"LONGNOSE SKATE",2004,0,3,3,0,0
"LONGNOSE SKATE",2005,0,1,1,0,0
"LONGNOSE SKATE",2007,0,2,2,0,0
"LONGNOSE SKATE",2009,0,1,1,0,0
"LONGNOSE SKATE",2010,0,1,1,0,0
"LONGNOSE SKATE",2011,0,2,2,0,0
"LONGNOSE SKATE",2012,0,1,1,0,0
"LONGNOSE SKATE",2013,0,1,1,0,0
"LONGNOSE SKATE",2016,0,2,2,0,0
"LONGNOSE SKATE",2019,0,6,6,0,0
"OLIVE ROCKFISH",2008,0,1,1,0,0
"OLIVE ROCKFISH",2009,0,2,2,0,0
"OLIVE ROCKFISH",2010,0,3,3,0,0
"OLIVE ROCKFISH",2011,0,2,2,0,0
"OLIVE ROCKFISH",2012,0,2,2,0,0
"OLIVE ROCKFISH",2013,0,9,9,0,0
"OLIVE ROCKFISH",2014,0,2,2,0,0
"OLIVE ROCKFISH",2015,0,6,6,0,0
"OLIVE ROCKFISH",2016,0,9,9,0,0
"OLIVE ROCKFISH",2017,0,1,1,0,0
"PACIFIC COD",2002,0,7,7,0,0
"PACIFIC COD",2003,0,20,20,0,0
"PACIFIC COD",2004,0,1,1,0,0
"PACIFIC COD",2009,0,2,2,0,0
"PACIFIC COD",2011,0,1,1,0,0
"PACIFIC COD",2012,0,20,20,0,0
"PACIFIC COD",2017,0,3,3,0,0
"PACIFIC COD",2019,0,2,2,0,0
"PACIFIC OCEAN PERCH",2002,0,2,2,0,0
"PACIFIC OCEAN PERCH",2013,0,1,1,0,0
"PACIFIC SANDDAB",2001,0,18,18,0,0
"PACIFIC SANDDAB",2002,0,18,18,0,0
"PACIFIC SANDDAB",2003,0,56,56,0,0
"PACIFIC SANDDAB",2004,0,339,339,0,0
"PACIFIC SANDDAB",2005,0,82,82,0,0
"PACIFIC SANDDAB",2006,0,29,29,0,0
"PACIFIC SANDDAB",2007,0,7,7,0,0
"PACIFIC SANDDAB",2008,0,46,46,0,0
"PACIFIC SANDDAB",2009,0,13,13,0,0
"PACIFIC SANDDAB",2010,0,85,85,0,0
"PACIFIC SANDDAB",2011,0,49,49,0,0
"PACIFIC SANDDAB",2012,0,151,151,0,0
"PACIFIC SANDDAB",2013,0,69,69,0,0
"PACIFIC SANDDAB",2014,0,82,82,0,0
"PACIFIC SANDDAB",2015,0,32,32,0,0
"PACIFIC SANDDAB",2016,0,39,39,0,0
"PACIFIC SANDDAB",2017,0,277,277,0,0
"PACIFIC SANDDAB",2018,0,59,59,0,0
"PACIFIC SANDDAB",2019,0,65,65,0,0
"PACIFIC SANDDAB",2020,0,12,12,0,0
"PETRALE SOLE",2001,0,3,3,0,0
"PETRALE SOLE",2002,0,6,6,0,0
"PETRALE SOLE",2003,0,41,41,0,0
"PETRALE SOLE",2004,0,27,27,0,0
"PETRALE SOLE",2005,0,10,10,0,0
"PETRALE SOLE",2006,0,10,10,0,0
"PETRALE SOLE",2007,0,9,9,0,0
"PETRALE SOLE",2008,0,25,25,0,0
"PETRALE SOLE",2009,0,10,10,0,0
"PETRALE SOLE",2010,0,12,12,0,0
"PETRALE SOLE",2011,0,37,37,0,0
"PETRALE SOLE",2012,0,61,61,0,0
"PETRALE SOLE",2013,0,159,159,0,0
"PETRALE SOLE",2014,0,111,111,0,0
"PETRALE SOLE",2015,0,98,98,0,0
"PETRALE SOLE",2016,0,268,268,0,0
"PETRALE SOLE",2017,0,385,385,0,0
"PETRALE SOLE",2018,0,345,345,0,0
"PETRALE SOLE",2019,0,409,409,0,0
"PETRALE SOLE",2020,0,4,4,0,0
"QUILLBACK ROCKFISH",2001,0,321,321,0,0
"QUILLBACK ROCKFISH",2002,0,757,757,0,0
"QUILLBACK ROCKFISH",2003,0,876,876,0,0
"QUILLBACK ROCKFISH",2004,0,500,500,0,0
"QUILLBACK ROCKFISH",2005,91,931,1022,91,0
"QUILLBACK ROCKFISH",2006,343,1033,1376,336,3
"QUILLBACK ROCKFISH",2007,309,1075,1384,0,311
"QUILLBACK ROCKFISH",2008,363,1120,1483,356,0
"QUILLBACK ROCKFISH",2009,245,825,1070,0,245
"QUILLBACK ROCKFISH",2010,372,919,1291,0,374
"QUILLBACK ROCKFISH",2011,333,1048,1381,0,337
"QUILLBACK ROCKFISH",2012,475,1241,1716,0,475
"QUILLBACK ROCKFISH",2013,283,753,1036,0,284
"QUILLBACK ROCKFISH",2014,193,484,677,0,193
"QUILLBACK ROCKFISH",2015,0,43,43,0,0
"QUILLBACK ROCKFISH",2016,0,27,27,0,0
"QUILLBACK ROCKFISH",2017,227,737,964,0,228
"QUILLBACK ROCKFISH",2018,349,1352,1701,0,349
"QUILLBACK ROCKFISH",2019,392,1235,1627,0,392
"QUILLBACK ROCKFISH",2020,153,39,192,0,153
"REDBANDED ROCKFISH",2001,0,4,4,0,0
"REDBANDED ROCKFISH",2002,0,4,4,0,0
"REDBANDED ROCKFISH",2003,0,1,1,0,0
"REDBANDED ROCKFISH",2004,0,7,7,0,0
"REDBANDED ROCKFISH",2005,0,4,4,0,0
"REDBANDED ROCKFISH",2006,0,8,8,0,0
"REDBANDED ROCKFISH",2007,0,5,5,0,0
"REDBANDED ROCKFISH",2010,0,7,7,0,0
"REDBANDED ROCKFISH",2013,0,2,2,0,0
"REDBANDED ROCKFISH",2016,0,2,2,0,0
"REDBANDED ROCKFISH",2018,0,1,1,0,0
"REDSTRIPE ROCKFISH",2001,0,57,57,0,0
"REDSTRIPE ROCKFISH",2002,0,32,32,0,0
"REDSTRIPE ROCKFISH",2003,0,51,51,0,0
"REDSTRIPE ROCKFISH",2004,0,14,14,0,0
"REDSTRIPE ROCKFISH",2005,0,32,32,0,0
"REDSTRIPE ROCKFISH",2008,0,1,1,0,0
"REDSTRIPE ROCKFISH",2011,0,6,6,0,0
"REDSTRIPE ROCKFISH",2012,0,4,4,0,0
"REDSTRIPE ROCKFISH",2013,0,2,2,0,0
"REDSTRIPE ROCKFISH",2014,0,6,6,0,0
"REDSTRIPE ROCKFISH",2015,0,14,14,0,0
"REDSTRIPE ROCKFISH",2016,0,2,2,0,0
"REDSTRIPE ROCKFISH",2017,0,13,13,0,0
"REDSTRIPE ROCKFISH",2018,0,9,9,0,0
"REDSTRIPE ROCKFISH",2019,0,12,12,0,0
"ROCK SOLE",2001,0,1,1,0,0
"ROCK SOLE",2004,0,4,4,0,0
"ROCK SOLE",2005,0,15,15,0,0
"ROCK SOLE",2006,0,5,5,0,0
"ROCK SOLE",2007,0,2,2,0,0
"ROCK SOLE",2008,0,1,1,0,0
"ROCK SOLE",2009,0,2,2,0,0
"ROCK SOLE",2010,0,5,5,0,0
"ROCK SOLE",2011,0,2,2,0,0
"ROCK SOLE",2012,0,3,3,0,0
"ROCK SOLE",2013,0,2,2,0,0
"ROCK SOLE",2014,0,3,3,0,0
"ROCK SOLE",2015,0,5,5,0,0
"ROCK SOLE",2016,0,1,1,0,0
"ROCK SOLE",2017,0,7,7,0,0
"ROCK SOLE",2018,0,3,3,0,0
"ROCK SOLE",2019,0,5,5,0,0
"ROSETHORN ROCKFISH",2001,0,63,63,0,0
"ROSETHORN ROCKFISH",2002,0,121,121,0,0
"ROSETHORN ROCKFISH",2003,0,58,58,0,0
"ROSETHORN ROCKFISH",2004,0,16,16,0,0
"ROSETHORN ROCKFISH",2005,0,24,24,0,0
"ROSETHORN ROCKFISH",2006,0,12,12,0,0
"ROSETHORN ROCKFISH",2007,0,20,20,0,0
"ROSETHORN ROCKFISH",2008,0,6,6,0,0
"ROSETHORN ROCKFISH",2009,0,17,17,0,0
"ROSETHORN ROCKFISH",2011,0,6,6,0,0
"ROSETHORN ROCKFISH",2012,0,15,15,0,0
"ROSETHORN ROCKFISH",2013,0,38,38,0,0
"ROSETHORN ROCKFISH",2014,0,15,15,0,0
"ROSETHORN ROCKFISH",2015,0,16,16,0,0
"ROSETHORN ROCKFISH",2016,0,24,24,0,0
"ROSETHORN ROCKFISH",2017,0,12,12,0,0
"ROSETHORN ROCKFISH",2018,0,11,11,0,0
"ROSETHORN ROCKFISH",2019,0,45,45,0,0
"ROSETHORN ROCKFISH",2020,0,2,2,0,0
"ROSY ROCKFISH",2001,0,96,96,0,0
"ROSY ROCKFISH",2002,0,41,41,0,0
"ROSY ROCKFISH",2003,0,23,23,0,0
"ROSY ROCKFISH",2004,0,3,3,0,0
"ROSY ROCKFISH",2005,0,7,7,0,0
"ROSY ROCKFISH",2006,0,6,6,0,0
"ROSY ROCKFISH",2007,0,3,3,0,0
"ROSY ROCKFISH",2009,0,2,2,0,0
"ROSY ROCKFISH",2011,0,4,4,0,0
"ROSY ROCKFISH",2012,0,9,9,0,0
"ROSY ROCKFISH",2013,0,4,4,0,0
"ROSY ROCKFISH",2015,0,2,2,0,0
"ROSY ROCKFISH",2017,0,6,6,0,0
"ROSY ROCKFISH",2018,0,4,4,0,0
"ROSY ROCKFISH",2019,0,8,8,0,0
"SABLEFISH",2001,0,49,49,0,0
"SABLEFISH",2002,0,154,154,0,0
"SABLEFISH",2003,0,238,238,0,0
"SABLEFISH",2004,0,75,75,0,0
"SABLEFISH",2005,0,107,107,0,0
"SABLEFISH",2006,0,141,141,0,0
"SABLEFISH",2007,0,239,239,0,0
"SABLEFISH",2008,0,157,157,0,0
"SABLEFISH",2009,0,37,37,0,0
"SABLEFISH",2010,0,19,19,0,0
"SABLEFISH",2011,0,65,65,0,0
"SABLEFISH",2012,0,34,34,0,0
"SABLEFISH",2013,0,105,105,0,0
"SABLEFISH",2014,0,75,75,0,0
"SABLEFISH",2015,0,91,91,0,0
"SABLEFISH",2016,0,65,65,0,0
"SABLEFISH",2017,0,96,96,0,0
"SABLEFISH",2018,0,165,165,0,0
"SABLEFISH",2019,0,143,143,0,0
"SAND SOLE",2001,0,7,7,0,0
"SAND SOLE",2002,0,31,31,0,0
"SAND SOLE",2003,0,20,20,0,0
"SAND SOLE",2004,0,42,42,0,0
"SAND SOLE",2005,0,38,38,0,0
"SAND SOLE",2006,0,15,15,0,0
"SAND SOLE",2007,0,11,11,0,0
"SAND SOLE",2008,0,20,20,0,0
"SAND SOLE",2009,0,61,61,0,0
"SAND SOLE",2010,0,109,109,0,0
"SAND SOLE",2011,0,67,67,0,0
"SAND SOLE",2012,0,37,37,0,0
"SAND SOLE",2013,0,50,50,0,0
"SAND SOLE",2014,0,51,51,0,0
"SAND SOLE",2015,0,61,61,0,0
"SAND SOLE",2016,0,81,81,0,0
"SAND SOLE",2017,0,89,89,0,0
"SAND SOLE",2018,0,41,41,0,0
"SAND SOLE",2019,0,30,30,0,0
"SILVERGRAY ROCKFISH",2001,0,9,9,0,0
"SILVERGRAY ROCKFISH",2002,0,24,24,0,0
"SILVERGRAY ROCKFISH",2003,0,20,20,0,0
"SILVERGRAY ROCKFISH",2004,0,3,3,0,0
"SILVERGRAY ROCKFISH",2005,0,14,14,0,0
"SILVERGRAY ROCKFISH",2006,0,2,2,0,0
"SILVERGRAY ROCKFISH",2007,0,4,4,0,0
"SILVERGRAY ROCKFISH",2008,0,4,4,0,0
"SILVERGRAY ROCKFISH",2009,0,25,25,0,0
"SILVERGRAY ROCKFISH",2011,0,90,90,0,0
"SILVERGRAY ROCKFISH",2012,0,42,42,0,0
"SILVERGRAY ROCKFISH",2013,0,22,22,0,0
"SILVERGRAY ROCKFISH",2014,0,42,42,0,0
"SILVERGRAY ROCKFISH",2015,0,7,7,0,0
"SILVERGRAY ROCKFISH",2016,0,1,1,0,0
"SILVERGRAY ROCKFISH",2017,0,9,9,0,0
"SILVERGRAY ROCKFISH",2018,0,29,29,0,0
"SILVERGRAY ROCKFISH",2019,0,14,14,0,0
"SPECKLED ROCKFISH",2019,0,1,1,0,0
"STARRY FLOUNDER",2001,0,3,3,0,0
"STARRY FLOUNDER",2002,0,17,17,0,0
"STARRY FLOUNDER",2003,0,62,62,0,0
"STARRY FLOUNDER",2004,0,34,34,0,0
"STARRY FLOUNDER",2005,0,26,26,0,0
"STARRY FLOUNDER",2006,0,15,15,0,0
"STARRY FLOUNDER",2007,0,4,4,0,0
"STARRY FLOUNDER",2008,0,16,16,0,0
"STARRY FLOUNDER",2009,0,5,5,0,0
"STARRY FLOUNDER",2010,0,2,2,0,0
"STARRY FLOUNDER",2011,0,24,24,0,0
"STARRY FLOUNDER",2012,0,7,7,0,0
"STARRY FLOUNDER",2013,0,3,3,0,0
"STARRY FLOUNDER",2014,0,5,5,0,0
"STARRY FLOUNDER",2015,0,9,9,0,0
"STARRY FLOUNDER",2016,0,9,9,0,0
"STARRY FLOUNDER",2017,0,16,16,0,0
"STARRY FLOUNDER",2018,0,4,4,0,0
"STARRY FLOUNDER",2019,0,4,4,0,0
"VERMILION ROCKFISH",2001,0,224,224,0,0
"VERMILION ROCKFISH",2002,0,450,450,0,0
"VERMILION ROCKFISH",2003,0,743,743,0,0
"VERMILION ROCKFISH",2004,0,413,413,0,0
"VERMILION ROCKFISH",2005,107,960,1067,115,16
"VERMILION ROCKFISH",2006,186,609,795,284,0
"VERMILION ROCKFISH",2007,206,823,1029,109,99
"VERMILION ROCKFISH",2008,327,739,1066,179,156
"VERMILION ROCKFISH",2009,188,501,689,97,92
"VERMILION ROCKFISH",2010,157,633,790,85,74
"VERMILION ROCKFISH",2011,191,724,915,101,90
"VERMILION ROCKFISH",2012,174,928,1102,89,85
"VERMILION ROCKFISH",2013,170,647,817,87,82
"VERMILION ROCKFISH",2014,84,373,457,43,43
"VERMILION ROCKFISH",2015,60,296,356,32,30
"VERMILION ROCKFISH",2016,49,271,320,29,21
"VERMILION ROCKFISH",2017,52,543,595,29,23
"VERMILION ROCKFISH",2018,47,575,622,29,18
"VERMILION ROCKFISH",2019,142,611,753,75,66
"VERMILION ROCKFISH",2020,115,64,179,67,48
"WIDOW ROCKFISH",2001,0,237,237,0,0
"WIDOW ROCKFISH",2002,0,260,260,0,0
"WIDOW ROCKFISH",2003,0,351,351,0,0
"WIDOW ROCKFISH",2004,0,124,124,0,0
"WIDOW ROCKFISH",2005,0,393,393,0,0
"WIDOW ROCKFISH",2006,0,179,179,0,0
"WIDOW ROCKFISH",2007,0,193,193,0,0
"WIDOW ROCKFISH",2008,0,230,230,0,0
"WIDOW ROCKFISH",2009,0,182,182,0,0
"WIDOW ROCKFISH",2010,0,119,119,0,0
"WIDOW ROCKFISH",2011,0,149,149,0,0
"WIDOW ROCKFISH",2012,0,276,276,0,0
"WIDOW ROCKFISH",2013,0,268,268,0,0
"WIDOW ROCKFISH",2014,0,159,159,0,0
"WIDOW ROCKFISH",2015,0,216,216,0,0
"WIDOW ROCKFISH",2016,0,64,64,0,0
"WIDOW ROCKFISH",2017,0,257,257,0,0
"WIDOW ROCKFISH",2018,0,966,966,0,0
"WIDOW ROCKFISH",2019,0,726,726,0,0
"WIDOW ROCKFISH",2020,0,21,21,0,0
"YELLOWEYE ROCKFISH",2001,0,368,368,0,0
"YELLOWEYE ROCKFISH",2002,0,448,448,0,0
"YELLOWEYE ROCKFISH",2003,0,492,492,0,0
"YELLOWEYE ROCKFISH",2004,0,23,23,0,0
"YELLOWEYE ROCKFISH",2005,1,25,26,0,0
"YELLOWEYE ROCKFISH",2006,0,49,49,0,0
"YELLOWEYE ROCKFISH",2007,0,62,62,0,0
"YELLOWEYE ROCKFISH",2008,0,74,74,0,0
"YELLOWEYE ROCKFISH",2009,0,39,39,0,0
"YELLOWEYE ROCKFISH",2010,0,28,28,0,0
"YELLOWEYE ROCKFISH",2011,0,49,49,0,0
"YELLOWEYE ROCKFISH",2012,0,112,112,0,0
"YELLOWEYE ROCKFISH",2013,0,57,57,0,0
"YELLOWEYE ROCKFISH",2014,0,89,89,0,0
"YELLOWEYE ROCKFISH",2015,0,42,42,0,0
"YELLOWEYE ROCKFISH",2016,0,34,34,0,0
"YELLOWEYE ROCKFISH",2017,0,102,102,0,0
"YELLOWEYE ROCKFISH",2018,0,120,120,0,0
"YELLOWEYE ROCKFISH",2019,0,120,120,0,0
"YELLOWEYE ROCKFISH",2020,0,12,12,0,0
"YELLOWMOUTH ROCKFISH",2001,0,1,1,0,0
"YELLOWMOUTH ROCKFISH",2002,0,12,12,0,0
"YELLOWMOUTH ROCKFISH",2003,0,1,1,0,0
"YELLOWMOUTH ROCKFISH",2009,0,3,3,0,0
"YELLOWMOUTH ROCKFISH",2012,0,1,1,0,0
"YELLOWMOUTH ROCKFISH",2013,0,1,1,0,0
"YELLOWTAIL ROCKFISH",1999,326,0,326,0,0
"YELLOWTAIL ROCKFISH",2000,192,0,192,0,0
"YELLOWTAIL ROCKFISH",2001,12,692,704,0,12
"YELLOWTAIL ROCKFISH",2002,0,1457,1457,0,0
"YELLOWTAIL ROCKFISH",2003,0,1740,1740,0,0
"YELLOWTAIL ROCKFISH",2004,1,1394,1395,0,0
"YELLOWTAIL ROCKFISH",2005,0,1916,1916,0,0
"YELLOWTAIL ROCKFISH",2006,0,1585,1585,0,0
"YELLOWTAIL ROCKFISH",2007,0,1721,1721,0,0
"YELLOWTAIL ROCKFISH",2008,0,2043,2043,0,0
"YELLOWTAIL ROCKFISH",2009,0,2678,2678,0,0
"YELLOWTAIL ROCKFISH",2010,0,2462,2462,0,0
"YELLOWTAIL ROCKFISH",2011,0,2318,2318,0,0
"YELLOWTAIL ROCKFISH",2012,1,2753,2754,0,0
"YELLOWTAIL ROCKFISH",2013,0,2182,2182,0,0
"YELLOWTAIL ROCKFISH",2014,0,1936,1936,0,0
"YELLOWTAIL ROCKFISH",2015,0,2018,2018,0,0
"YELLOWTAIL ROCKFISH",2016,0,870,870,0,0
"YELLOWTAIL ROCKFISH",2017,0,1347,1347,0,0
"YELLOWTAIL ROCKFISH",2018,0,2607,2607,0,0
"YELLOWTAIL ROCKFISH",2019,0,2866,2866,0,0
"YELLOWTAIL ROCKFISH",2020,0,129,129,0,0
"DEACON ROCKFISH",2008,826,0,826,461,361
"DEACON ROCKFISH",2009,940,4,944,384,555
"DEACON ROCKFISH",2010,832,10,842,344,495
"DEACON ROCKFISH",2011,767,17,784,374,398
"DEACON ROCKFISH",2012,838,27,865,400,457
"DEACON ROCKFISH",2013,616,5,621,367,246
"DEACON ROCKFISH",2014,617,4,621,361,250
"DEACON ROCKFISH",2015,669,2,671,386,281
"DEACON ROCKFISH",2016,645,2555,3200,0,649
"DEACON ROCKFISH",2017,544,2526,3070,0,544
"DEACON ROCKFISH",2018,557,2097,2654,0,558
"DEACON ROCKFISH",2019,740,3140,3880,0,743
"DEACON ROCKFISH",2020,572,267,839,0,574
"BLACK AND YELLOW ROCKFISH",2004,0,2,2,0,0
"BLACK AND YELLOW ROCKFISH",2005,0,1,1,0,0
"BLACK AND YELLOW ROCKFISH",2010,3,9,12,0,3
"BLACK AND YELLOW ROCKFISH",2012,0,1,1,0,0
"BLACK AND YELLOW ROCKFISH",2013,1,3,4,0,1
"BLACK AND YELLOW ROCKFISH",2014,2,2,4,0,2
"BLACK AND YELLOW ROCKFISH",2017,0,1,1,0,0
"BLACK AND YELLOW ROCKFISH",2018,0,1,1,0,0
"BLACK AND YELLOW ROCKFISH",2019,0,3,3,0,0
"SPINY DOGFISH SHARK",2002,0,1,1,0,0
"SPINY DOGFISH SHARK",2003,0,3,3,0,0
"SPINY DOGFISH SHARK",2004,0,2,2,0,0
"SPINY DOGFISH SHARK",2005,0,1,1,0,0
"SPINY DOGFISH SHARK",2006,0,2,2,0,0
"SPINY DOGFISH SHARK",2007,0,2,2,0,0
"SPINY DOGFISH SHARK",2009,0,5,5,0,0
"SPINY DOGFISH SHARK",2010,0,2,2,0,0
"SPINY DOGFISH SHARK",2012,0,4,4,0,0
"SPINY DOGFISH SHARK",2014,0,2,2,0,0
"SPINY DOGFISH SHARK",2015,0,1,1,0,0
"SPINY DOGFISH SHARK",2017,0,1,1,0,0
"SPINY DOGFISH SHARK",2018,0,1,1,0,0
"SPINY DOGFISH SHARK",2002,0,1,1,0,0
"SPINY DOGFISH SHARK",2003,0,3,3,0,0
"SPINY DOGFISH SHARK",2004,0,2,2,0,0
"SPINY DOGFISH SHARK",2005,0,1,1,0,0
"SPINY DOGFISH SHARK",2006,0,2,2,0,0
"SPINY DOGFISH SHARK",2007,0,2,2,0,0
"SPINY DOGFISH SHARK",2009,0,5,5,0,0
"SPINY DOGFISH SHARK",2010,0,2,2,0,0
"SPINY DOGFISH SHARK",2012,0,4,4,0,0
"SPINY DOGFISH SHARK",2014,0,2,2,0,0
"SPINY DOGFISH SHARK",2015,0,1,1,0,0
"SPINY DOGFISH SHARK",2017,0,1,1,0,0
"SPINY DOGFISH SHARK",2018,0,1,1,0,0
